30 100
TCCCTGAAGATCTTTGGGAGGGCACTATAG|TAAATAAACTGGGGGGCCGCGCAGGAGATC
TTCATCTTATCGCATCGATAGGGGAAAAGC|TAAACAATATCGCCGATGGGCATCCTGTGT
TAGCAATAAACAATATCGCCGATGGGCATC|AAATTCCCACTTATGAATGCCTTATCGGTG
TAATACGTTAGAGGTGGAGCACTAAACAAT|TCGTCCTTGCTAGGCTCGAGTCCCGGGGGA
ATCGCCGATGGGCATCCTGTGTCTTGGTTT|CCTGTGTCACGCGATACGGCCTGATATGGG
AATATCGCCGATGGGCATCCTGTGTGGGCA|ACGTTAGAGGTGGAGCACTAAACAATATCG
TAAACTGGGGGGCCGCGCAGGAGATCCTAA|TTTACGTATAGTCCACCGATGACTTCCTAG
CTATGTTAAACAATATCGCCGATGGGCATC|TACAATACCCGTATCTTCATCTTATCGCAT
TATCCCAAGACTTTTGTCCGGAAATTCCCA|TGGTCTTCATTAAACAATATCTAAACAATA
CCCGTATCTTCATCTTATCGCATCGATAGG|GCGTATGATAAACAATATCGCCGATGGGCA
ATCGCTACTAAGCGAATCTATTCAACCACC|GCATCCTGTGTTGATACTTCAGGTACGTAT
TCGCCGATGGGCATCCTGTGTTCCTGTGTC|ATCCTGTGTTTGGATGGACTCTCCGGGATA
CGATACGGCCTGATATGGGTGAGATTTTAG|TCGCCGATGGGCATCCTGTGTGGGCATAAA
GGGGCCGCGCAGGAGATCCTAATATCCCAA|TAGTCCACCGATGACTTCCTAGTGGTCTTC
CCGATGGGCATCCTGTGTCACGCGATACGG|CAATATCGCCGATTAAACAATATCGCCGAT
ACTACAATACCCGTATCTTCATCTTATCGC|TTCGATTAAGCGTATGATAAACAATATCGC
CCTCAGCTTCGTAATACGTTAGAGGTGGAG|CTATAGTGGACTCGTCCTTGCTAGGCTCGA
GCCGATGGGCATCCTGTGTGGGCATAAACA|GAGGTGGAGCACTAAACAATATCGCCGATG
CAAACATAAAGGTGCGTGGCTCTTGCAGTA|CAATATCGCCGATGGGCATCCTGTGTTAGT
CTGGCCAAAACAGTAAACAATATCGCCGAT|AACAATATCGCCGATGGGCATCCTGTGTCA
TCACAGGCTATCCTAGCGTACGACCCACGA|GGGCATCCTGTGTCTTGGTTTTCCCCGTAA
AGGTTACGGCAGAACGTGTTTATCGGCTAT|AACAATATCGCCGATGGGCATCCTGTGTTC
TACCTATGTTAAACAATATCGCCGATGGGC|TACTACAATACCCGTATCTTCATCTTATCG
CGACATACCTATGTTAAACAATATCGCCGA|GAACCTACTACAATACCCGTATCTTCATCT
TAAGCGAATCTATTCAACCACCTAACTCAG|TGTTGATACTTCAGGTACGTATCGAAGCCC
CCGATGGGCATCCTGTGTTCTTTGCTGCAG|ATCTTATCGCATCGATAGGGGAAAAGCATT
CGTTTAGCGGGGTGTGTTTACTCCCTGAAG|TGGCTCCGGACGCCAAGAGGGTAAATAAAC
TGGGCATCCTGTGTTGAGCCCGGCAATGGA|TATCGGTGAGCCCGCTATCGCTACTAAGCG
GGCATCCTGTGTCACGCGATACGGCCTGAT|CGCCGATTAAACAATATCGCCGATGGGCAT
CATAAACAATATCGCCGATGGGCATCCTGT|CGCCGATGGGCATCCTGTGTTTGGATGGAC
TGCAGTAAATAAACAATATCGCCGATTAAA|TGTTAGTAGAGCATAGCCTCAGCTTCGTAA
CGCGACATACCTATGTTAAACAATATCGCC|AAGAACCTACTACAATACCCGTATCTTCAT
TTAAACAATATCGCCGATGGGCATCCTGTG|GCATCCTGTGTTCTTTGCTGCAGTGGGCCT
ACTAAACAATATCGCCGATGGGCATCCTGT|TCCCGGGGGAGAATCTTAGAACACTCAAGC
TATCTATAGTGGACTCGTCCTTGCTAGGCT|ATGGGCATCCTGTGTTAATATCCCCATGTA
CCGGAAATTCCCACTTATGAATGCCTTATC|TATCTAAACAATATCGCCGATGGGCATCCT
GATCAGGGCCGGTGGTGCCGAGAACTCTAT|CGCTTCGTGAAATGGGTTGGTCACTATAAA
CTCTGGCCAAAACAGTAAACAATATCGCCG|TAAACAATATCGCCGATGGGCATCCTGTGT
CAAGCAGCACCAATATATTCCCTCTAACCA|CGGGGTGTGTTTACTCCCTGAAGATCTTTG
GTCCGGAAATTCCCACTTATGAATGCCTTA|AATATCTAAACAATATCGCCGATGGGCATC
GGTAAATAAACTGGGGGGCCGCGCAGGAGA|CAGCGATTTACGTATAGTCCACCGATGACT
CCCAAGACTTTTGTCCGGAAATTCCCACTT|TCTTCATTAAACAATATCTAAACAATATCG
GGTGAGCCCGCTATCGCTACTAAGCGAATC|GTGTGCCGATGGGCATCCTGTGTTGATACT
GAACGTGTTTATCGGCTATGACGCCTCGGC|CGATGGGCATCCTGTGTTCCTGTGTCCGAT
CACTATAAACAATATCGCCGATGGGCATCC|TTGGCTCTGCATCGACGTTAGCAATAAACA
TTGAGCCCGGCAATGGATATGGCTCCGGAC|GCTATCGCTACTAAGCGAATCTATTCAACC
GACAATTCGATTAAGCGTATGATAAACAAT|GGCAGAACGTGTTTATCGGCTATGACGCCT
CTGTGTGGGCATAAACAATATCGCCGATGG|AAACAATATCGCCGATGGGCATCCTGTGTT
TATCGCCGATTAAACAATATCGCCGATGGG|CCTCAGCTTCGTAATACGTTAGAGGTGGAG
TTCACTAGTTAGGCGTTTAGCGGGGTGTGT|CCGGCAATGGATATGGCTCCGGACGCCAAG
GCTCTGCATCGACGTTAGCAATAAACAATA|AAGACTTTTGTCCGGAAATTCCCACTTATG
TCTTGCAGTAAATAAACAATATCGCCGATT|CTGTGTTAGTAGAGCATAGCCTCAGCTTCG
TAGGCTCGAGTCCCGGGGGAGAATCTTAGA|CATGTATCGTACCACTTCACTAGTTAGGCG
GTGATTGGCTCTGCATCGACGTTAGCAATA|ATATCCCAAGACTTTTGTCCGGAAATTCCC
ATCCTGTGTCTTGGTTTTCCCCGTAAGGAA|ATACGGCCTGATATGGGTGAGATTTTAGGT
AATATCGCCGATGGGCATCCTGTGTGAAAA|AGGCCTCACAGGCTATCCTAGCGTACGACC
GTATCTTCATCTTATCGCATCGATAGGGGA|TATGATAAACAATATCGCCGATGGGCATCC
CAAGAGGGTAAATAAACTGGGGGGCCGCGC|CTAACTCAGCGATTTACGTATAGTCCACCG
CATCGACGTTAGCAATAAACAATATCGCCG|TTTGTCCGGAAATTCCCACTTATGAATGCC
GGCCGGTGGTGCCGAGAACTCTATGTGAGA|GTGAAATGGGTTGGTCACTATAAACAATAT
ACTATAGACGGTGATTGGCTCTGCATCGAC|GGAGATCCTAATATCCCAAGACTTTTGTCC
CTATTTGTCTTAAACAATATCGCCGATGGG|CGCCGATGGGCATCCTGTGTTCTTTGCTGC
GGGGGGCCGCGCAGGAGATCCTAATATCCC|TATAGTCCACCGATGACTTCCTAGTGGTCT
CCGATGGGCATCCTGTGTTTGGATGGACTC|CTTAGAACACTCAAGCAGCACCAATATATT
AGTTAGGCGTTTAGCGGGGTGTGTTTACTC|ATGGATATGGCTCCGGACGCCAAGAGGGTA
ATCCCAGAATTACAAGGACTAAACAATATC|TGTAGGGTAGAATAGAAAAGCTATAGGCCT
ACGGCCTGATATGGGTGAGATTTTAGGTTA|CGATGGGCATCCTGTGTGGGCATAAACAAT
CAGTAAACAATATCGCCGATGGGCATCCTG|CCGATGGGCATCCTGTGTCACGCGATACGG
CTGTGTCCGCGAAAGTAAACAATATCGCCG|AGGTGCGTGGCTCTTGCAGTAAATAAACAA
AATTACAAGGACTAAACAATATCGCCGATG|TAGAATAGAAAAGCTATAGGCCTCACAGGC
CCGATTAAACAATATCGCCGATGGGCATCC|GCTTCGTAATACGTTAGAGGTGGAGCACTA
CTGTGTTAATATCCCCATGTATCGTACCAC|AATATCGCCGATGGGCATCCTGTGTTGAGC
GTTAGGCGTTTAGCGGGGTGTGTTTACTCC|TGGATATGGCTCCGGACGCCAAGAGGGTAA
TGGGGGGCCGCGCAGGAGATCCTAATATCC|GTATAGTCCACCGATGACTTCCTAGTGGTC
GGTGGAGCACTAAACAATATCGCCGATGGG|GGCTCGAGTCCCGGGGGAGAATCTTAGAAC
TACGGCAGAACGTGTTTATCGGCTATGACG|ATATCGCCGATGGGCATCCTGTGTTCCTGT
TCCTGTGTCCGCGAAAGTAAACAATATCGC|AAAGGTGCGTGGCTCTTGCAGTAAATAAAC
AATGGATATGGCTCCGGACGCCAAGAGGGT|TAAGCGAATCTATTCAACCACCTAACTCAG
AGAATAGAAAAGCTATAGGCCTCACAGGCT|ACAGTAAACAATATCGCCGATGGGCATCCT
TGGCTATTTGTCTTAAACAATATCGCCGAT|TATCGCCGATGGGCATCCTGTGTTCTTTGC
CGTGAAATGGGTTGGTCACTATAAACAATA|GCACTATAGACGGTGATTGGCTCTGCATCG
AATATCGCCGATGGGCATCCTGTGTCCGCG|CCTCGGCTCCCAAACATAAAGGTGCGTGGC
TATGGGTGAGATTTTAGGTTACGGCAGAAC|TCCTGTGTGGGCATAAACAATATCGCCGAT
GCCTCAGCTTCGTAATACGTTAGAGGTGGA|TCTATAGTGGACTCGTCCTTGCTAGGCTCG
GATGGGCATCCTGTGTCATCCCAGAATTAC|TGCTGCAGTGGGCCTAGTGTAGGGTAGAAT
AATTGGCTATTTGTCTTAAACAATATCGCC|CAATATCGCCGATGGGCATCCTGTGTTCTT
TGTTGAGCCCGGCAATGGATATGGCTCCGG|CCGCTATCGCTACTAAGCGAATCTATTCAA
ATCCTGTGTCATCCCAGAATTACAAGGACT|GTGGGCCTAGTGTAGGGTAGAATAGAAAAG
AATACGTTAGAGGTGGAGCACTAAACAATA|CGTCCTTGCTAGGCTCGAGTCCCGGGGGAG
GGTGTGTTTACTCCCTGAAGATCTTTGGGA|CGCCAAGAGGGTAAATAAACTGGGGGGCCG
GATATGGGTGAGATTTTAGGTTACGGCAGA|CATCCTGTGTGGGCATAAACAATATCGCCG
GTTAGCAATAAACAATATCGCCGATGGGCA|GGAAATTCCCACTTATGAATGCCTTATCGG
TACTACAATACCCGTATCTTCATCTTATCG|ATTCGATTAAGCGTATGATAAACAATATCG
CCAAGAGGGTAAATAAACTGGGGGGCCGCG|CCTAACTCAGCGATTTACGTATAGTCCACC
ACGCGATACGGCCTGATATGGGTGAGATTT|ATATCGCCGATGGGCATCCTGTGTGGGCAT
GTGTTCTTTGCTGCAGTGGGCCTAGTGTAG|ATAGGGGAAAAGCATTGTACGGCTCTGGCC
TGTGTCCGATAAACAATATCGCCGATGGGC|GGGATAGAGATCAGGGCCGGTGGTGCCGAG
GTGTTTGGATGGACTCTCCGGGATAGAGAT|GCAGCACCAATATATTCCCTCTAACCACGC
GTTTATCGGCTATGACGCCTCGGCTCCCAA|GCATCCTGTGTTCCTGTGTCCGATAAACAA
TGTGAAAAACTCAACATCGCGACATACCTA|GTACGACCCACGATGGGAAGAACCTACTAC
ACATAAAGGTGCGTGGCTCTTGCAGTAAAT|TATCGCCGATGGGCATCCTGTGTTAGTAGA
ACCCACGATGGGAAGAACCTACTACAATAC|CCCCGTAAGGAAGCGGACAATTCGATTAAG
GGGATAGAGATCAGGGCCGGTGGTGCCGAG|TCTAACCACGCTTCGTGAAATGGGTTGGTC
ACATACCTATGTTAAACAATATCGCCGATG|ACCTACTACAATACCCGTATCTTCATCTTA
ACTTATGAATGCCTTATCGGTGAGCCCGCT|ATCGCCGATGGGCATCCTGTGTGCCGATGG
ATCGCCGATGGGCATCCTGTGTTAATATCC|GACGTTAGCAATAAACAATATCGCCGATGG
AGTCCCGGGGGAGAATCTTAGAACACTCAA|GTACCACTTCACTAGTTAGGCGTTTAGCGG
GTAATACGTTAGAGGTGGAGCACTAAACAA|CTCGTCCTTGCTAGGCTCGAGTCCCGGGGG
CGGCAGAACGTGTTTATCGGCTATGACGCC|ATCGCCGATGGGCATCCTGTGTTCCTGTGT
GTGGAGCACTAAACAATATCGCCGATGGGC|GCTCGAGTCCCGGGGGAGAATCTTAGAACA
TGAGATACTATATCTATAGTGGACTCGTCC|AATATCGCCGATGGGCATCCTGTGTTAATA
TCCTAGCGTACGACCCACGATGGGAAGAAC|TGTCTTGGTTTTCCCCGTAAGGAAGCGGAC
AACATCGCGACATACCTATGTTAAACAATA|ATGGGAAGAACCTACTACAATACCCGTATC
CGCCGATGGGCATCCTGTGTGAAAAACTCA|TCACAGGCTATCCTAGCGTACGACCCACGA
GATATGGCTCCGGACGCCAAGAGGGTAAAT|CGAATCTATTCAACCACCTAACTCAGCGAT
CGTACCACTTCACTAGTTAGGCGTTTAGCG|TGTTGAGCCCGGCAATGGATATGGCTCCGG
CTGAAGATCTTTGGGAGGGCACTATAGACG|ATAAACTGGGGGGCCGCGCAGGAGATCCTA
CAAGGACTAAACAATATCGCCGATGGGCAT|TAGAAAAGCTATAGGCCTCACAGGCTATCC
TATCGCCGATGGGCATCCTGTGTTAGTAGA|CCGGTGGTGCCGAGAACTCTATGTGAGATA
CGCGATACGGCCTGATATGGGTGAGATTTT|TATCGCCGATGGGCATCCTGTGTGGGCATA
ATCCTAATATCCCAAGACTTTTGTCCGGAA|TTCCTAGTGGTCTTCATTAAACAATATCTA
AAACAATATCGCCGATGGGCATCCTGTGTC|CAGTAAATAAACAATATCGCCGATTAAACA
TGTTCCTGTGTCCGATAAACAATATCGCCG|CTCTCCGGGATAGAGATCAGGGCCGGTGGT
GCTAGGCTCGAGTCCCGGGGGAGAATCTTA|CCCATGTATCGTACCACTTCACTAGTTAGG
TGTTCTTTGCTGCAGTGGGCCTAGTGTAGG|TAGGGGAAAAGCATTGTACGGCTCTGGCCA
CCCTGAAGATCTTTGGGAGGGCACTATAGA|AAATAAACTGGGGGGCCGCGCAGGAGATCC
GATGGGCATCCTGTGTTCCTGTGTCCGATA|GTGTTTGGATGGACTCTCCGGGATAGAGAT
GTATGATAAACAATATCGCCGATGGGCATC|CGGCTATGACGCCTCGGCTCCCAAACATAA
CGCTACTAAGCGAATCTATTCAACCACCTA|ATCCTGTGTTGATACTTCAGGTACGTATCG
GGTGCGTGGCTCTTGCAGTAAATAAACAAT|GATGGGCATCCTGTGTTAGTAGAGCATAGC
TGTGTTGAGCCCGGCAATGGATATGGCTCC|GCCCGCTATCGCTACTAAGCGAATCTATTC
AGTGGGCCTAGTGTAGGGTAGAATAGAAAA|TTGTACGGCTCTGGCCAAAACAGTAAACAA
TAGGGTAGAATAGAAAAGCTATAGGCCTCA|GCCAAAACAGTAAACAATATCGCCGATGGG
GATTGGCTCTGCATCGACGTTAGCAATAAA|ATCCCAAGACTTTTGTCCGGAAATTCCCAC
ACTGGGGGGCCGCGCAGGAGATCCTAATAT|ACGTATAGTCCACCGATGACTTCCTAGTGG
TAGCGTACGACCCACGATGGGAAGAACCTA|CTTGGTTTTCCCCGTAAGGAAGCGGACAAT
CTTCACTAGTTAGGCGTTTAGCGGGGTGTG|CCCGGCAATGGATATGGCTCCGGACGCCAA
AAGCGAATCTATTCAACCACCTAACTCAGC|GTTGATACTTCAGGTACGTATCGAAGCCCT
TTCAACCACCTAACTCAGCGATTTACGTAT|AGGTACGTATCGAAGCCCTATCCGCGCGAC
CCGATGGGCATCCTGTGTTAGTAGAGCATA|GGTGCCGAGAACTCTATGTGAGATACTATA
GGAGGGCACTATAGACGGTGATTGGCTCTG|CCGCGCAGGAGATCCTAATATCCCAAGACT
GCATCGATAGGGGAAAAGCATTGTACGGCT|GCCGATGGGCATCCTGTGTCCGCGAAAGTA
CATGAATTGGCTATTTGTCTTAAACAATAT|TAAACAATATCGCCGATGGGCATCCTGTGT
CGCTTCGTGAAATGGGTTGGTCACTATAAA|GGAGGGCACTATAGACGGTGATTGGCTCTG
TAAACAATATCGCCGATGGGCATCCTGTGT|CCGGGGGAGAATCTTAGAACACTCAAGCAG
AGATTTTAGGTTACGGCAGAACGTGTTTAT|GGGCATAAACAATATCGCCGATGGGCATCC
GTAGGGTAGAATAGAAAAGCTATAGGCCTC|GGCCAAAACAGTAAACAATATCGCCGATGG
GAATCTTAGAACACTCAAGCAGCACCAATA|TAGTTAGGCGTTTAGCGGGGTGTGTTTACT
AACTCAACATCGCGACATACCTATGTTAAA|CCACGATGGGAAGAACCTACTACAATACCC
GATGGGCATCCTGTGTTGAGCCCGGCAATG|CTTATCGGTGAGCCCGCTATCGCTACTAAG
TCTTATCGCATCGATAGGGGAAAAGCATTG|CAATATCGCCGATGGGCATCCTGTGTCCGC
GCCGATGGGCATCCTGTGTCTTGGTTTTCC|GTGTCACGCGATACGGCCTGATATGGGTGA
GCCTCACAGGCTATCCTAGCGTACGACCCA|GATGGGCATCCTGTGTCTTGGTTTTCCCCG
CGTTAGAGGTGGAGCACTAAACAATATCGC|CTTGCTAGGCTCGAGTCCCGGGGGAGAATC
TGTCCGGAAATTCCCACTTATGAATGCCTT|CAATATCTAAACAATATCGCCGATGGGCAT
ACAGGCTATCCTAGCGTACGACCCACGATG|GCATCCTGTGTCTTGGTTTTCCCCGTAAGG
GGTGCCGAGAACTCTATGTGAGATACTATA|GGGTTGGTCACTATAAACAATATCGCCGAT
AGGGTAAATAAACTGGGGGGCCGCGCAGGA|CTCAGCGATTTACGTATAGTCCACCGATGA
AATATCGCCGATTAAACAATATCGCCGATG|AGCCTCAGCTTCGTAATACGTTAGAGGTGG
TATCGGCTATGACGCCTCGGCTCCCAAACA|TCCTGTGTTCCTGTGTCCGATAAACAATAT
ATAGAGATCAGGGCCGGTGGTGCCGAGAAC|AACCACGCTTCGTGAAATGGGTTGGTCACT
CCTGTGTCATCCCAGAATTACAAGGACTAA|GGGCCTAGTGTAGGGTAGAATAGAAAAGCT
CCTGTGTTTGGATGGACTCTCCGGGATAGA|CAAGCAGCACCAATATATTCCCTCTAACCA
CATCCTGTGTTCTTTGCTGCAGTGGGCCTA|GCATCGATAGGGGAAAAGCATTGTACGGCT
CAACATCGCGACATACCTATGTTAAACAAT|GATGGGAAGAACCTACTACAATACCCGTAT
TGTAGGGTAGAATAGAAAAGCTATAGGCCT|TGGCCAAAACAGTAAACAATATCGCCGATG
AGATCTTTGGGAGGGCACTATAGACGGTGA|ACTGGGGGGCCGCGCAGGAGATCCTAATAT
AATATCGCCGATGGGCATCCTGTGTTCCTG|GGGCATCCTGTGTTTGGATGGACTCTCCGG
TATGAATGCCTTATCGGTGAGCCCGCTATC|GCCGATGGGCATCCTGTGTGCCGATGGGCA
GCTATCCTAGCGTACGACCCACGATGGGAA|CCTGTGTCTTGGTTTTCCCCGTAAGGAAGC
CAATATCGCCGATTAAACAATATCGCCGAT|TAGCCTCAGCTTCGTAATACGTTAGAGGTG
GGGTTGGTCACTATAAACAATATCGCCGAT|GACGGTGATTGGCTCTGCATCGACGTTAGC
CCTAGCGTACGACCCACGATGGGAAGAACC|GTCTTGGTTTTCCCCGTAAGGAAGCGGACA
CTATCCTAGCGTACGACCCACGATGGGAAG|CTGTGTCTTGGTTTTCCCCGTAAGGAAGCG
AACAATATCGCCGATGGGCATCCTGTGTTC|GATGGGCATCCTGTGTTTGGATGGACTCTC
AATCTTAGAACACTCAAGCAGCACCAATAT|AGTTAGGCGTTTAGCGGGGTGTGTTTACTC
ATGGGCATCCTGTGTTCTTTGCTGCAGTGG|TTATCGCATCGATAGGGGAAAAGCATTGTA
TCTATTCAACCACCTAACTCAGCGATTTAC|CTTCAGGTACGTATCGAAGCCCTATCCGCG
GGACTAAACAATATCGCCGATGGGCATCCT|AAAAGCTATAGGCCTCACAGGCTATCCTAG
AATACCCGTATCTTCATCTTATCGCATCGA|TTAAGCGTATGATAAACAATATCGCCGATG
GCGGGGTGTGTTTACTCCCTGAAGATCTTT|CGGACGCCAAGAGGGTAAATAAACTGGGGG
TTATCGCATCGATAGGGGAAAAGCATTGTA|ATATCGCCGATGGGCATCCTGTGTCCGCGA
GACGCCTCGGCTCCCAAACATAAAGGTGCG|CTGTGTCCGATAAACAATATCGCCGATGGG
CATCCTGTGTCCGCGAAAGTAAACAATATC|ATAAAGGTGCGTGGCTCTTGCAGTAAATAA
GCCGATGGGCATCCTGTGTCATCCCAGAAT|CTTTGCTGCAGTGGGCCTAGTGTAGGGTAG
CTCCGGGATAGAGATCAGGGCCGGTGGTGC|TCCCTCTAACCACGCTTCGTGAAATGGGTT
ATGGATATGGCTCCGGACGCCAAGAGGGTA|AAGCGAATCTATTCAACCACCTAACTCAGC
TGGGCATCCTGTGTGAAAAACTCAACATCG|GCTATCCTAGCGTACGACCCACGATGGGAA
TCTGGCCAAAACAGTAAACAATATCGCCGA|AAACAATATCGCCGATGGGCATCCTGTGTC
TCCTGTGTTAATATCCCCATGTATCGTACC|ACAATATCGCCGATGGGCATCCTGTGTTGA
TACGGCCTGATATGGGTGAGATTTTAGGTT|CCGATGGGCATCCTGTGTGGGCATAAACAA
GCCTTATCGGTGAGCCCGCTATCGCTACTA|GGCATCCTGTGTGCCGATGGGCATCCTGTG
CCAAGACTTTTGTCCGGAAATTCCCACTTA|CTTCATTAAACAATATCTAAACAATATCGC
TCCTGTGTCCGATAAACAATATCGCCGATG|TCCGGGATAGAGATCAGGGCCGGTGGTGCC
CCGCGAAAGTAAACAATATCGCCGATGGGC|GTGGCTCTTGCAGTAAATAAACAATATCGC
ACTTTTGTCCGGAAATTCCCACTTATGAAT|TTAAACAATATCTAAACAATATCGCCGATG
CTTAAACAATATCGCCGATGGGCATCCTGT|GGCATCCTGTGTTCTTTGCTGCAGTGGGCC
TATTTGTCTTAAACAATATCGCCGATGGGC|GCCGATGGGCATCCTGTGTTCTTTGCTGCA
AGCATTGTACGGCTCTGGCCAAAACAGTAA|TGTCCGCGAAAGTAAACAATATCGCCGATG
AAACAATATCGCCGATGGGCATCCTGTGTT|CGATGGGCATCCTGTGTTTGGATGGACTCT
AAACAATATCGCCGATGGGCATCCTGTGTT|CGGGGGAGAATCTTAGAACACTCAAGCAGC
ACCCGTATCTTCATCTTATCGCATCGATAG|AGCGTATGATAAACAATATCGCCGATGGGC
AACAATATCGCCGATGGGCATCCTGTGTTA|CAGGGCCGGTGGTGCCGAGAACTCTATGTG
CTGTGTTCCTGTGTCCGATAAACAATATCG|GGACTCTCCGGGATAGAGATCAGGGCCGGT
CGCCAAGAGGGTAAATAAACTGGGGGGCCG|CACCTAACTCAGCGATTTACGTATAGTCCA
CTCCCAAACATAAAGGTGCGTGGCTCTTGC|TAAACAATATCGCCGATGGGCATCCTGTGT
AATATATTCCCTCTAACCACGCTTCGTGAA|TACTCCCTGAAGATCTTTGGGAGGGCACTA
ATATTCCCTCTAACCACGCTTCGTGAAATG|TCCCTGAAGATCTTTGGGAGGGCACTATAG
CGGCTCTGGCCAAAACAGTAAACAATATCG|AAGTAAACAATATCGCCGATGGGCATCCTG
TGTCTTGGTTTTCCCCGTAAGGAAGCGGAC|CCTGATATGGGTGAGATTTTAGGTTACGGC
TATCCTAGCGTACGACCCACGATGGGAAGA|TGTGTCTTGGTTTTCCCCGTAAGGAAGCGG
ACGGCTCTGGCCAAAACAGTAAACAATATC|AAAGTAAACAATATCGCCGATGGGCATCCT
GTTGAGCCCGGCAATGGATATGGCTCCGGA|CGCTATCGCTACTAAGCGAATCTATTCAAC
GACATACCTATGTTAAACAATATCGCCGAT|AACCTACTACAATACCCGTATCTTCATCTT
CAATATCGCCGATGGGCATCCTGTGTTCCT|TGGGCATCCTGTGTTTGGATGGACTCTCCG
GGGAAGAACCTACTACAATACCCGTATCTT|GAAGCGGACAATTCGATTAAGCGTATGATA
GTAAATAAACTGGGGGGCCGCGCAGGAGAT|AGCGATTTACGTATAGTCCACCGATGACTT
CTTGGTTTTCCCCGTAAGGAAGCGGACAAT|GATATGGGTGAGATTTTAGGTTACGGCAGA
AAACAATATCGCCGATGGGCATCCTGTGTG|TAATACGTTAGAGGTGGAGCACTAAACAAT
GTGTCATCCCAGAATTACAAGGACTAAACA|CCTAGTGTAGGGTAGAATAGAAAAGCTATA
GCATCCTGTGTCTTGGTTTTCCCCGTAAGG|CGATACGGCCTGATATGGGTGAGATTTTAG
ATATCCCAAGACTTTTGTCCGGAAATTCCC|GTGGTCTTCATTAAACAATATCTAAACAAT
CAATATCGCCGATGGGCATCCTGTGTTCTT|GTATCTTCATCTTATCGCATCGATAGGGGA
GCCGGTGGTGCCGAGAACTCTATGTGAGAT|TGAAATGGGTTGGTCACTATAAACAATATC
GTCCGCGAAAGTAAACAATATCGCCGATGG|GCGTGGCTCTTGCAGTAAATAAACAATATC
GGGCATCCTGTGTTAATATCCCCATGTATC|AATAAACAATATCGCCGATGGGCATCCTGT
GGCTCTTGCAGTAAATAAACAATATCGCCG|ATCCTGTGTTAGTAGAGCATAGCCTCAGCT
GAGGGTAAATAAACTGGGGGGCCGCGCAGG|ACTCAGCGATTTACGTATAGTCCACCGATG
GTCACTATAAACAATATCGCCGATGGGCAT|GATTGGCTCTGCATCGACGTTAGCAATAAA
AAGGACTAAACAATATCGCCGATGGGCATC|AGAAAAGCTATAGGCCTCACAGGCTATCCT
CTCTTGCAGTAAATAAACAATATCGCCGAT|CCTGTGTTAGTAGAGCATAGCCTCAGCTTC
CGCCGATGGGCATCCTGTGTCATCCCAGAA|TCTTTGCTGCAGTGGGCCTAGTGTAGGGTA
ATCTTATCGCATCGATAGGGGAAAAGCATT|ACAATATCGCCGATGGGCATCCTGTGTCCG
AGCCTCAGCTTCGTAATACGTTAGAGGTGG|ATCTATAGTGGACTCGTCCTTGCTAGGCTC
TACAATACCCGTATCTTCATCTTATCGCAT|CGATTAAGCGTATGATAAACAATATCGCCG
GTAAACAATATCGCCGATGGGCATCCTGTG|GATGGGCATCCTGTGTCACGCGATACGGCC
TCGCCGATGGGCATCCTGTGTTCTTTGCTG|TTCATCTTATCGCATCGATAGGGGAAAAGC
ACTCCCTGAAGATCTTTGGGAGGGCACTAT|GGTAAATAAACTGGGGGGCCGCGCAGGAGA
ATATGGCTCCGGACGCCAAGAGGGTAAATA|GAATCTATTCAACCACCTAACTCAGCGATT
TCACTAGTTAGGCGTTTAGCGGGGTGTGTT|CGGCAATGGATATGGCTCCGGACGCCAAGA
TCCTGTGTTGAGCCCGGCAATGGATATGGC|TGAGCCCGCTATCGCTACTAAGCGAATCTA
CGCCGATGGGCATCCTGTGTTCTTTGCTGC|TCATCTTATCGCATCGATAGGGGAAAAGCA
CGCAGGAGATCCTAATATCCCAAGACTTTT|CCGATGACTTCCTAGTGGTCTTCATTAAAC
CGAAAGTAAACAATATCGCCGATGGGCATC|GCTCTTGCAGTAAATAAACAATATCGCCGA
GATGGACTCTCCGGGATAGAGATCAGGGCC|CAATATATTCCCTCTAACCACGCTTCGTGA
TACTATATCTATAGTGGACTCGTCCTTGCT|CGCCGATGGGCATCCTGTGTTAATATCCCC
GGCCGCGCAGGAGATCCTAATATCCCAAGA|GTCCACCGATGACTTCCTAGTGGTCTTCAT
GTTCTTTGCTGCAGTGGGCCTAGTGTAGGG|AGGGGAAAAGCATTGTACGGCTCTGGCCAA
CCTAGTGTAGGGTAGAATAGAAAAGCTATA|GGCTCTGGCCAAAACAGTAAACAATATCGC
AATATCCCAAGACTTTTGTCCGGAAATTCC|AGTGGTCTTCATTAAACAATATCTAAACAA
TAAACAATATCGCCGATGGGCATCCTGTGT|ACCCGTATCTTCATCTTATCGCATCGATAG
TCAACCACCTAACTCAGCGATTTACGTATA|GGTACGTATCGAAGCCCTATCCGCGCGACT
GGGCATCCTGTGTTCCTGTGTCCGATAAAC|TTTGGATGGACTCTCCGGGATAGAGATCAG
GAAAAGCTATAGGCCTCACAGGCTATCCTA|AACAATATCGCCGATGGGCATCCTGTGTCT
TTGGCTATTTGTCTTAAACAATATCGCCGA|ATATCGCCGATGGGCATCCTGTGTTCTTTG
TGGGCCTAGTGTAGGGTAGAATAGAAAAGC|GTACGGCTCTGGCCAAAACAGTAAACAATA
GTTTAGCGGGGTGTGTTTACTCCCTGAAGA|GGCTCCGGACGCCAAGAGGGTAAATAAACT
AGTGGACTCGTCCTTGCTAGGCTCGAGTCC|TCCTGTGTTAATATCCCCATGTATCGTACC
TCCTGTGTCATCCCAGAATTACAAGGACTA|TGGGCCTAGTGTAGGGTAGAATAGAAAAGC
CTTTGGGAGGGCACTATAGACGGTGATTGG|GGGGGCCGCGCAGGAGATCCTAATATCCCA
CGATTAAACAATATCGCCGATGGGCATCCT|CTTCGTAATACGTTAGAGGTGGAGCACTAA
GACGCCAAGAGGGTAAATAAACTGGGGGGC|ACCACCTAACTCAGCGATTTACGTATAGTC
CTAACCACGCTTCGTGAAATGGGTTGGTCA|ATCTTTGGGAGGGCACTATAGACGGTGATT
CCTGTGTCCGATAAACAATATCGCCGATGG|CCGGGATAGAGATCAGGGCCGGTGGTGCCG
GAGATCAGGGCCGGTGGTGCCGAGAACTCT|CACGCTTCGTGAAATGGGTTGGTCACTATA
GGGTGTGTTTACTCCCTGAAGATCTTTGGG|ACGCCAAGAGGGTAAATAAACTGGGGGGCC
AATGCCTTATCGGTGAGCCCGCTATCGCTA|ATGGGCATCCTGTGTGCCGATGGGCATCCT
ACAATATCGCCGATGGGCATCCTGTGTGAA|ATAGGCCTCACAGGCTATCCTAGCGTACGA
CCGATGGGCATCCTGTGTCTTGGTTTTCCC|TGTCACGCGATACGGCCTGATATGGGTGAG
GCCGATGGGCATCCTGTGTTAGTAGAGCAT|TGGTGCCGAGAACTCTATGTGAGATACTAT
TCCTGTGTTTGGATGGACTCTCCGGGATAG|TCAAGCAGCACCAATATATTCCCTCTAACC
TGATATGGGTGAGATTTTAGGTTACGGCAG|GCATCCTGTGTGGGCATAAACAATATCGCC
ATCGCCGATGGGCATCCTGTGTTCTTTGCT|CTTCATCTTATCGCATCGATAGGGGAAAAG
GGGCCGGTGGTGCCGAGAACTCTATGTGAG|CGTGAAATGGGTTGGTCACTATAAACAATA
ATTCCCACTTATGAATGCCTTATCGGTGAG|AACAATATCGCCGATGGGCATCCTGTGTGC
CCGATAAACAATATCGCCGATGGGCATCCT|AGAGATCAGGGCCGGTGGTGCCGAGAACTC
TTCCTGTGTCCGATAAACAATATCGCCGAT|CTCCGGGATAGAGATCAGGGCCGGTGGTGC
ATGGGTGAGATTTTAGGTTACGGCAGAACG|CCTGTGTGGGCATAAACAATATCGCCGATG
TCCTGTGTGAAAAACTCAACATCGCGACAT|CTAGCGTACGACCCACGATGGGAAGAACCT
GGATAGAGATCAGGGCCGGTGGTGCCGAGA|CTAACCACGCTTCGTGAAATGGGTTGGTCA
TCGTCCTTGCTAGGCTCGAGTCCCGGGGGA|TTAATATCCCCATGTATCGTACCACTTCAC
TACTCCCTGAAGATCTTTGGGAGGGCACTA|GGGTAAATAAACTGGGGGGCCGCGCAGGAG
TTTTGTCCGGAAATTCCCACTTATGAATGC|AAACAATATCTAAACAATATCGCCGATGGG
ATCTTAGAACACTCAAGCAGCACCAATATA|GTTAGGCGTTTAGCGGGGTGTGTTTACTCC
ATAGCCTCAGCTTCGTAATACGTTAGAGGT|ATATCTATAGTGGACTCGTCCTTGCTAGGC
TAGAGCATAGCCTCAGCTTCGTAATACGTT|GATACTATATCTATAGTGGACTCGTCCTTG
TTTATCGGCTATGACGCCTCGGCTCCCAAA|CATCCTGTGTTCCTGTGTCCGATAAACAAT
TAATATCCCCATGTATCGTACCACTTCACT|GCCGATGGGCATCCTGTGTTGAGCCCGGCA
TATAAACAATATCGCCGATGGGCATCCTGT|GCTCTGCATCGACGTTAGCAATAAACAATA
ATCGCCGATGGGCATCCTGTGTTGAGCCCG|GAATGCCTTATCGGTGAGCCCGCTATCGCT
GCAATAAACAATATCGCCGATGGGCATCCT|ATTCCCACTTATGAATGCCTTATCGGTGAG
TTTGTCCGGAAATTCCCACTTATGAATGCC|AACAATATCTAAACAATATCGCCGATGGGC
AGTAAACAATATCGCCGATGGGCATCCTGT|CGATGGGCATCCTGTGTCACGCGATACGGC
GTTAGAGGTGGAGCACTAAACAATATCGCC|TTGCTAGGCTCGAGTCCCGGGGGAGAATCT
GTATCGTACCACTTCACTAGTTAGGCGTTT|CCTGTGTTGAGCCCGGCAATGGATATGGCT
CCTGAAGATCTTTGGGAGGGCACTATAGAC|AATAAACTGGGGGGCCGCGCAGGAGATCCT
GGTCACTATAAACAATATCGCCGATGGGCA|TGATTGGCTCTGCATCGACGTTAGCAATAA
TGAAATGGGTTGGTCACTATAAACAATATC|ACTATAGACGGTGATTGGCTCTGCATCGAC
CCGATGGGCATCCTGTGTTAATATCCCCAT|TTAGCAATAAACAATATCGCCGATGGGCAT
GCTATCGCTACTAAGCGAATCTATTCAACC|TGGGCATCCTGTGTTGATACTTCAGGTACG
TCCCCGTAAGGAAGCGGACAATTCGATTAA|TGAGATTTTAGGTTACGGCAGAACGTGTTT
TCAAGCAGCACCAATATATTCCCTCTAACC|GCGGGGTGTGTTTACTCCCTGAAGATCTTT
CACGCTTCGTGAAATGGGTTGGTCACTATA|TGGGAGGGCACTATAGACGGTGATTGGCTC
TCAGCTTCGTAATACGTTAGAGGTGGAGCA|ATAGTGGACTCGTCCTTGCTAGGCTCGAGT
CCCTCTAACCACGCTTCGTGAAATGGGTTG|GAAGATCTTTGGGAGGGCACTATAGACGGT
TATCGCCGATGGGCATCCTGTGTCACGCGA|ATAAACAATATCGCCGATTAAACAATATCG
ATCCTGTGTCCGCGAAAGTAAACAATATCG|TAAAGGTGCGTGGCTCTTGCAGTAAATAAA
GGATGGACTCTCCGGGATAGAGATCAGGGC|CCAATATATTCCCTCTAACCACGCTTCGTG
ATATCGCCGATGGGCATCCTGTGTCATCCC|GTGTTCTTTGCTGCAGTGGGCCTAGTGTAG
GTGTCTTGGTTTTCCCCGTAAGGAAGCGGA|GCCTGATATGGGTGAGATTTTAGGTTACGG
CGATGGGAAGAACCTACTACAATACCCGTA|TAAGGAAGCGGACAATTCGATTAAGCGTAT
CGCCGATGGGCATCCTGTGTCTTGGTTTTC|TGTGTCACGCGATACGGCCTGATATGGGTG
TAGGTTACGGCAGAACGTGTTTATCGGCTA|AAACAATATCGCCGATGGGCATCCTGTGTT
AAATGGGTTGGTCACTATAAACAATATCGC|TATAGACGGTGATTGGCTCTGCATCGACGT
ATTCAACCACCTAACTCAGCGATTTACGTA|CAGGTACGTATCGAAGCCCTATCCGCGCGA
CAATATCGCCGATGGGCATCCTGTGTGAAA|TAGGCCTCACAGGCTATCCTAGCGTACGAC
ATATCGCCGATGGGCATCCTGTGTTAGTAG|GCCGGTGGTGCCGAGAACTCTATGTGAGAT
AACTGGGGGGCCGCGCAGGAGATCCTAATA|TACGTATAGTCCACCGATGACTTCCTAGTG
CTTTTGTCCGGAAATTCCCACTTATGAATG|TAAACAATATCTAAACAATATCGCCGATGG
CTACTAAGCGAATCTATTCAACCACCTAAC|CCTGTGTTGATACTTCAGGTACGTATCGAA
GTGTCCGCGAAAGTAAACAATATCGCCGAT|GTGCGTGGCTCTTGCAGTAAATAAACAATA
TGGGCATCCTGTGTTAGTAGAGCATAGCCT|CCGAGAACTCTATGTGAGATACTATATCTA
TGGGCATCCTGTGTCACGCGATACGGCCTG|ATCGCCGATTAAACAATATCGCCGATGGGC
AACAATATCGCCGATGGGCATCCTGTGTGG|AATACGTTAGAGGTGGAGCACTAAACAATA
CCAAACATAAAGGTGCGTGGCTCTTGCAGT|ACAATATCGCCGATGGGCATCCTGTGTTAG
CATCCTGTGTTTGGATGGACTCTCCGGGAT|ACTCAAGCAGCACCAATATATTCCCTCTAA
CGATGGGCATCCTGTGTGGGCATAAACAAT|GGTGGAGCACTAAACAATATCGCCGATGGG
AATATCGCCGATGGGCATCCTGTGTCATCC|TGTGTTCTTTGCTGCAGTGGGCCTAGTGTA
CGATGGGCATCCTGTGTGAAAAACTCAACA|CAGGCTATCCTAGCGTACGACCCACGATGG
TGTTAGTAGAGCATAGCCTCAGCTTCGTAA|ATGTGAGATACTATATCTATAGTGGACTCG
ACCTATGTTAAACAATATCGCCGATGGGCA|ACTACAATACCCGTATCTTCATCTTATCGC
TATGACGCCTCGGCTCCCAAACATAAAGGT|TTCCTGTGTCCGATAAACAATATCGCCGAT
AGACTTTTGTCCGGAAATTCCCACTTATGA|CATTAAACAATATCTAAACAATATCGCCGA
TCCCGGGGGAGAATCTTAGAACACTCAAGC|ACCACTTCACTAGTTAGGCGTTTAGCGGGG
AACAATATCGCCGATGGGCATCCTGTGTCA|TCCTGTGTTCTTTGCTGCAGTGGGCCTAGT
AGGAGATCCTAATATCCCAAGACTTTTGTC|ATGACTTCCTAGTGGTCTTCATTAAACAAT
ACTAAACAATATCGCCGATGGGCATCCTGT|AAGCTATAGGCCTCACAGGCTATCCTAGCG
GAAGCGGACAATTCGATTAAGCGTATGATA|GGTTACGGCAGAACGTGTTTATCGGCTATG
ATCGCCGATGGGCATCCTGTGTCATCCCAG|GTTCTTTGCTGCAGTGGGCCTAGTGTAGGG
CAATATCGCCGATGGGCATCCTGTGTTAAT|CATCGACGTTAGCAATAAACAATATCGCCG
CACAGGCTATCCTAGCGTACGACCCACGAT|GGCATCCTGTGTCTTGGTTTTCCCCGTAAG
GCCGATGGGCATCCTGTGTCCGCGAAAGTA|CTCCCAAACATAAAGGTGCGTGGCTCTTGC
GCCGAGAACTCTATGTGAGATACTATATCT|TTGGTCACTATAAACAATATCGCCGATGGG
CAAGACTTTTGTCCGGAAATTCCCACTTAT|TTCATTAAACAATATCTAAACAATATCGCC
GTGTTAGTAGAGCATAGCCTCAGCTTCGTA|TATGTGAGATACTATATCTATAGTGGACTC
TTTCCCCGTAAGGAAGCGGACAATTCGATT|GGTGAGATTTTAGGTTACGGCAGAACGTGT
GCCTGATATGGGTGAGATTTTAGGTTACGG|TGGGCATCCTGTGTGGGCATAAACAATATC
TATTCCCTCTAACCACGCTTCGTGAAATGG|CCCTGAAGATCTTTGGGAGGGCACTATAGA
AATTCCCACTTATGAATGCCTTATCGGTGA|AAACAATATCGCCGATGGGCATCCTGTGTG
TGGCTCCGGACGCCAAGAGGGTAAATAAAC|TCTATTCAACCACCTAACTCAGCGATTTAC
AGCCCGGCAATGGATATGGCTCCGGACGCC|ATCGCTACTAAGCGAATCTATTCAACCACC
GGACAATTCGATTAAGCGTATGATAAACAA|CGGCAGAACGTGTTTATCGGCTATGACGCC
ATAAAGGTGCGTGGCTCTTGCAGTAAATAA|TCGCCGATGGGCATCCTGTGTTAGTAGAGC
AAGCATTGTACGGCTCTGGCCAAAACAGTA|GTGTCCGCGAAAGTAAACAATATCGCCGAT
CGATTAAGCGTATGATAAACAATATCGCCG|CGTGTTTATCGGCTATGACGCCTCGGCTCC
ATTACAAGGACTAAACAATATCGCCGATGG|AGAATAGAAAAGCTATAGGCCTCACAGGCT
GGCATCCTGTGTTGAGCCCGGCAATGGATA|TCGGTGAGCCCGCTATCGCTACTAAGCGAA
AACAATATCGCCGATGGGCATCCTGTGTTG|ACTTATGAATGCCTTATCGGTGAGCCCGCT
TATTCAACCACCTAACTCAGCGATTTACGT|TCAGGTACGTATCGAAGCCCTATCCGCGCG
CACGCGATACGGCCTGATATGGGTGAGATT|AATATCGCCGATGGGCATCCTGTGTGGGCA
ATGGGCATCCTGTGTTAGTAGAGCATAGCC|GCCGAGAACTCTATGTGAGATACTATATCT
GTGGGCATAAACAATATCGCCGATGGGCAT|AATATCGCCGATGGGCATCCTGTGTTTGGA
AAAGTAAACAATATCGCCGATGGGCATCCT|TCTTGCAGTAAATAAACAATATCGCCGATT
ATCGCATCGATAGGGGAAAAGCATTGTACG|ATCGCCGATGGGCATCCTGTGTCCGCGAAA
GGAAATTCCCACTTATGAATGCCTTATCGG|TCTAAACAATATCGCCGATGGGCATCCTGT
AGCTATAGGCCTCACAGGCTATCCTAGCGT|ATATCGCCGATGGGCATCCTGTGTCTTGGT
ATCGCCGATGGGCATCCTGTGTTAGTAGAG|CGGTGGTGCCGAGAACTCTATGTGAGATAC
ATATCGCCGATGGGCATCCTGTGTGGGCAT|CGTTAGAGGTGGAGCACTAAACAATATCGC
CATCGCGACATACCTATGTTAAACAATATC|GGGAAGAACCTACTACAATACCCGTATCTT
GCATCCTGTGTCACGCGATACGGCCTGATA|GCCGATTAAACAATATCGCCGATGGGCATC
ACAATATCGCCGATGGGCATCCTGTGTCTT|GGCATCCTGTGTCACGCGATACGGCCTGAT
CGATGGGCATCCTGTGTTTGGATGGACTCT|TTAGAACACTCAAGCAGCACCAATATATTC
AAGAACCTACTACAATACCCGTATCTTCAT|GCGGACAATTCGATTAAGCGTATGATAAAC
ATGTTAAACAATATCGCCGATGGGCATCCT|CAATACCCGTATCTTCATCTTATCGCATCG
CCGATGGGCATCCTGTGTGGGCATAAACAA|AGGTGGAGCACTAAACAATATCGCCGATGG
CTCAACATCGCGACATACCTATGTTAAACA|ACGATGGGAAGAACCTACTACAATACCCGT
ATGGGCATCCTGTGTCATCCCAGAATTACA|GCTGCAGTGGGCCTAGTGTAGGGTAGAATA
AGAACACTCAAGCAGCACCAATATATTCCC|GCGTTTAGCGGGGTGTGTTTACTCCCTGAA
CTGTGTCACGCGATACGGCCTGATATGGGT|TTAAACAATATCGCCGATGGGCATCCTGTG
GGGTAGAATAGAAAAGCTATAGGCCTCACA|CAAAACAGTAAACAATATCGCCGATGGGCA
GAACACTCAAGCAGCACCAATATATTCCCT|CGTTTAGCGGGGTGTGTTTACTCCCTGAAG
GTGTTTATCGGCTATGACGCCTCGGCTCCC|GGGCATCCTGTGTTCCTGTGTCCGATAAAC
AAACAATATCGCCGATGGGCATCCTGTGTC|TGGGCATCCTGTGTCACGCGATACGGCCTG
GGGCATAAACAATATCGCCGATGGGCATCC|TATCGCCGATGGGCATCCTGTGTTTGGATG
GAGCCCGGCAATGGATATGGCTCCGGACGC|TATCGCTACTAAGCGAATCTATTCAACCAC
CGATGGGCATCCTGTGTTAATATCCCCATG|TAGCAATAAACAATATCGCCGATGGGCATC
ATTGGCTCTGCATCGACGTTAGCAATAAAC|TCCCAAGACTTTTGTCCGGAAATTCCCACT
AAATAAACTGGGGGGCCGCGCAGGAGATCC|CGATTTACGTATAGTCCACCGATGACTTCC
ACCAATATATTCCCTCTAACCACGCTTCGT|GTTTACTCCCTGAAGATCTTTGGGAGGGCA
TAGGGGAAAAGCATTGTACGGCTCTGGCCA|GGCATCCTGTGTCCGCGAAAGTAAACAATA
CATCCTGTGTGAAAAACTCAACATCGCGAC|TCCTAGCGTACGACCCACGATGGGAAGAAC
TTATCGGTGAGCCCGCTATCGCTACTAAGC|ATCCTGTGTGCCGATGGGCATCCTGTGTTG
TGGGCATCCTGTGTCTTGGTTTTCCCCGTA|ACGCGATACGGCCTGATATGGGTGAGATTT
TTGGTCACTATAAACAATATCGCCGATGGG|GGTGATTGGCTCTGCATCGACGTTAGCAAT
CCGATGGGCATCCTGTGTGAAAAACTCAAC|ACAGGCTATCCTAGCGTACGACCCACGATG
ATCCTAGCGTACGACCCACGATGGGAAGAA|GTGTCTTGGTTTTCCCCGTAAGGAAGCGGA
AAATAAACAATATCGCCGATTAAACAATAT|TAGAGCATAGCCTCAGCTTCGTAATACGTT
ATGGGCATCCTGTGTCACGCGATACGGCCT|TATCGCCGATTAAACAATATCGCCGATGGG
GATGGGAAGAACCTACTACAATACCCGTAT|AAGGAAGCGGACAATTCGATTAAGCGTATG
CTAAACAATATCGCCGATGGGCATCCTGTG|CCCGGGGGAGAATCTTAGAACACTCAAGCA
CTGGGGGGCCGCGCAGGAGATCCTAATATC|CGTATAGTCCACCGATGACTTCCTAGTGGT
AGAATTACAAGGACTAAACAATATCGCCGA|GGTAGAATAGAAAAGCTATAGGCCTCACAG
ATTTTAGGTTACGGCAGAACGTGTTTATCG|GCATAAACAATATCGCCGATGGGCATCCTG
AATATCGCCGATGGGCATCCTGTGTTAGTA|GGCCGGTGGTGCCGAGAACTCTATGTGAGA
TCGCCGATGGGCATCCTGTGTGGGCATAAA|TAGAGGTGGAGCACTAAACAATATCGCCGA
AGCGAATCTATTCAACCACCTAACTCAGCG|TTGATACTTCAGGTACGTATCGAAGCCCTA
GGCATCCTGTGTCATCCCAGAATTACAAGG|GCAGTGGGCCTAGTGTAGGGTAGAATAGAA
TAGCCTCAGCTTCGTAATACGTTAGAGGTG|TATCTATAGTGGACTCGTCCTTGCTAGGCT
CAGTAAATAAACAATATCGCCGATTAAACA|TTAGTAGAGCATAGCCTCAGCTTCGTAATA
TAGAATAGAAAAGCTATAGGCCTCACAGGC|AACAGTAAACAATATCGCCGATGGGCATCC
GAAATGGGTTGGTCACTATAAACAATATCG|CTATAGACGGTGATTGGCTCTGCATCGACG
CGATGGGCATCCTGTGTTGAGCCCGGCAAT|CCTTATCGGTGAGCCCGCTATCGCTACTAA
CAATATCGCCGATGGGCATCCTGTGTCTTG|GCATCCTGTGTCACGCGATACGGCCTGATA
GGATATGGCTCCGGACGCCAAGAGGGTAAA|GCGAATCTATTCAACCACCTAACTCAGCGA
TCGCCGATGGGCATCCTGTGTTGAGCCCGG|AATGCCTTATCGGTGAGCCCGCTATCGCTA
ATAAACTGGGGGGCCGCGCAGGAGATCCTA|ATTTACGTATAGTCCACCGATGACTTCCTA
CCATGTATCGTACCACTTCACTAGTTAGGC|GCATCCTGTGTTGAGCCCGGCAATGGATAT
GGGCATCCTGTGTCTTGGTTTTCCCCGTAA|CGCGATACGGCCTGATATGGGTGAGATTTT
GTTAATATCCCCATGTATCGTACCACTTCA|TCGCCGATGGGCATCCTGTGTTGAGCCCGG
TGCCTTATCGGTGAGCCCGCTATCGCTACT|GGGCATCCTGTGTGCCGATGGGCATCCTGT
ATCGATAGGGGAAAAGCATTGTACGGCTCT|CGATGGGCATCCTGTGTCCGCGAAAGTAAA
AATATCGCCGATGGGCATCCTGTGTCTTGG|CATCCTGTGTCACGCGATACGGCCTGATAT
GGGCATCCTGTGTCCGCGAAAGTAAACAAT|AACATAAAGGTGCGTGGCTCTTGCAGTAAA
ATCGCCGATGGGCATCCTGTGTCACGCGAT|TAAACAATATCGCCGATTAAACAATATCGC
CGCCGATGGGCATCCTGTGTTGAGCCCGGC|ATGCCTTATCGGTGAGCCCGCTATCGCTAC
GTTACGGCAGAACGTGTTTATCGGCTATGA|CAATATCGCCGATGGGCATCCTGTGTTCCT
GATGGGCATCCTGTGTCCGCGAAAGTAAAC|CCAAACATAAAGGTGCGTGGCTCTTGCAGT
TAAACAATATCGCCGATGGGCATCCTGTGT|ATGGGCATCCTGTGTCACGCGATACGGCCT
TATCGCCGATGGGCATCCTGTGTTTGGATG|AGAATCTTAGAACACTCAAGCAGCACCAAT
TAGTGTAGGGTAGAATAGAAAAGCTATAGG|CTCTGGCCAAAACAGTAAACAATATCGCCG
TTGTACGGCTCTGGCCAAAACAGTAAACAA|CGCGAAAGTAAACAATATCGCCGATGGGCA
TCCCAAGACTTTTGTCCGGAAATTCCCACT|GTCTTCATTAAACAATATCTAAACAATATC
GTAAGGAAGCGGACAATTCGATTAAGCGTA|TTTTAGGTTACGGCAGAACGTGTTTATCGG
CCAGAATTACAAGGACTAAACAATATCGCC|AGGGTAGAATAGAAAAGCTATAGGCCTCAC
TCCGCGAAAGTAAACAATATCGCCGATGGG|CGTGGCTCTTGCAGTAAATAAACAATATCG
CTAAGCGAATCTATTCAACCACCTAACTCA|GTGTTGATACTTCAGGTACGTATCGAAGCC
GAAATTCCCACTTATGAATGCCTTATCGGT|CTAAACAATATCGCCGATGGGCATCCTGTG
AAAGGTGCGTGGCTCTTGCAGTAAATAAAC|GCCGATGGGCATCCTGTGTTAGTAGAGCAT
CGGTGATTGGCTCTGCATCGACGTTAGCAA|TAATATCCCAAGACTTTTGTCCGGAAATTC
CAGCACCAATATATTCCCTCTAACCACGCT|GTGTGTTTACTCCCTGAAGATCTTTGGGAG
CTAGTGTAGGGTAGAATAGAAAAGCTATAG|GCTCTGGCCAAAACAGTAAACAATATCGCC
CACTATAGACGGTGATTGGCTCTGCATCGA|AGGAGATCCTAATATCCCAAGACTTTTGTC
TCGCCGATGGGCATCCTGTGTCTTGGTTTT|CTGTGTCACGCGATACGGCCTGATATGGGT
TGTGTGGGCATAAACAATATCGCCGATGGG|AACAATATCGCCGATGGGCATCCTGTGTTT
AAAAGCTATAGGCCTCACAGGCTATCCTAG|ACAATATCGCCGATGGGCATCCTGTGTCTT
CAGGAGATCCTAATATCCCAAGACTTTTGT|GATGACTTCCTAGTGGTCTTCATTAAACAA
TATGTGAGATACTATATCTATAGTGGACTC|AAACAATATCGCCGATGGGCATCCTGTGTT
CGCCGATGGGCATCCTGTGTTCCTGTGTCC|TCCTGTGTTTGGATGGACTCTCCGGGATAG
CTGTGTGAAAAACTCAACATCGCGACATAC|AGCGTACGACCCACGATGGGAAGAACCTAC
CGGCTCCCAAACATAAAGGTGCGTGGCTCT|CGATAAACAATATCGCCGATGGGCATCCTG
AAGCGGACAATTCGATTAAGCGTATGATAA|GTTACGGCAGAACGTGTTTATCGGCTATGA
ATAAACAATATCGCCGATGGGCATCCTGTG|CCCACTTATGAATGCCTTATCGGTGAGCCC
GGGGAAAAGCATTGTACGGCTCTGGCCAAA|CATCCTGTGTCCGCGAAAGTAAACAATATC
CGACGTTAGCAATAAACAATATCGCCGATG|GTCCGGAAATTCCCACTTATGAATGCCTTA
GCTATGACGCCTCGGCTCCCAAACATAAAG|TGTTCCTGTGTCCGATAAACAATATCGCCG
TGGACTCGTCCTTGCTAGGCTCGAGTCCCG|CTGTGTTAATATCCCCATGTATCGTACCAC
CCGGTGGTGCCGAGAACTCTATGTGAGATA|GAAATGGGTTGGTCACTATAAACAATATCG
TCCGGGATAGAGATCAGGGCCGGTGGTGCC|CCCTCTAACCACGCTTCGTGAAATGGGTTG
GATGGGCATCCTGTGTTTGGATGGACTCTC|TAGAACACTCAAGCAGCACCAATATATTCC
AAACTGGGGGGCCGCGCAGGAGATCCTAAT|TTACGTATAGTCCACCGATGACTTCCTAGT
AAGGAAGCGGACAATTCGATTAAGCGTATG|TTAGGTTACGGCAGAACGTGTTTATCGGCT
CAATATCGCCGATGGGCATCCTGTGTCCGC|GCCTCGGCTCCCAAACATAAAGGTGCGTGG
ATAGGGGAAAAGCATTGTACGGCTCTGGCC|GGGCATCCTGTGTCCGCGAAAGTAAACAAT
ATCTATTCAACCACCTAACTCAGCGATTTA|ACTTCAGGTACGTATCGAAGCCCTATCCGC
GCATCCTGTGTTGAGCCCGGCAATGGATAT|CGGTGAGCCCGCTATCGCTACTAAGCGAAT
ATACGGCCTGATATGGGTGAGATTTTAGGT|GCCGATGGGCATCCTGTGTGGGCATAAACA
GTGTCACGCGATACGGCCTGATATGGGTGA|AAACAATATCGCCGATGGGCATCCTGTGTG
TAACCACGCTTCGTGAAATGGGTTGGTCAC|TCTTTGGGAGGGCACTATAGACGGTGATTG
AAAACAGTAAACAATATCGCCGATGGGCAT|ATCGCCGATGGGCATCCTGTGTCACGCGAT
CAATATCGCCGATGGGCATCCTGTGTTAGT|GGGCCGGTGGTGCCGAGAACTCTATGTGAG
CGGACAATTCGATTAAGCGTATGATAAACA|ACGGCAGAACGTGTTTATCGGCTATGACGC
TCGCCGATTAAACAATATCGCCGATGGGCA|TCAGCTTCGTAATACGTTAGAGGTGGAGCA
AAGAGGGTAAATAAACTGGGGGGCCGCGCA|TAACTCAGCGATTTACGTATAGTCCACCGA
TGGGCATCCTGTGTGGGCATAAACAATATC|GGAGCACTAAACAATATCGCCGATGGGCAT
TTAGAGGTGGAGCACTAAACAATATCGCCG|TGCTAGGCTCGAGTCCCGGGGGAGAATCTT
TAAACAATATCGCCGATGGGCATCCTGTGT|CATCCTGTGTTCTTTGCTGCAGTGGGCCTA
TGTTAAACAATATCGCCGATGGGCATCCTG|AATACCCGTATCTTCATCTTATCGCATCGA
TCCTGTGTTCTTTGCTGCAGTGGGCCTAGT|ATCGATAGGGGAAAAGCATTGTACGGCTCT
CACTAGTTAGGCGTTTAGCGGGGTGTGTTT|GGCAATGGATATGGCTCCGGACGCCAAGAG
CGATGGGCATCCTGTGTTAGTAGAGCATAG|GTGCCGAGAACTCTATGTGAGATACTATAT
TATAGGCCTCACAGGCTATCCTAGCGTACG|TCGCCGATGGGCATCCTGTGTCTTGGTTTT
TATCGCCGATGGGCATCCTGTGTCATCCCA|TGTTCTTTGCTGCAGTGGGCCTAGTGTAGG
GGGTAAATAAACTGGGGGGCCGCGCAGGAG|TCAGCGATTTACGTATAGTCCACCGATGAC
GACTCGTCCTTGCTAGGCTCGAGTCCCGGG|GTGTTAATATCCCCATGTATCGTACCACTT
TAAGCGTATGATAAACAATATCGCCGATGG|TTTATCGGCTATGACGCCTCGGCTCCCAAA
GAAGATCTTTGGGAGGGCACTATAGACGGT|AAACTGGGGGGCCGCGCAGGAGATCCTAAT
CCCAGAATTACAAGGACTAAACAATATCGC|TAGGGTAGAATAGAAAAGCTATAGGCCTCA
CAATATCGCCGATGGGCATCCTGTGTCACG|TAAATAAACAATATCGCCGATTAAACAATA
TTAGGTTACGGCAGAACGTGTTTATCGGCT|TAAACAATATCGCCGATGGGCATCCTGTGT
CGTTAGCAATAAACAATATCGCCGATGGGC|CGGAAATTCCCACTTATGAATGCCTTATCG
AAGGTGCGTGGCTCTTGCAGTAAATAAACA|CCGATGGGCATCCTGTGTTAGTAGAGCATA
GCTATTTGTCTTAAACAATATCGCCGATGG|TCGCCGATGGGCATCCTGTGTTCTTTGCTG
AACCTACTACAATACCCGTATCTTCATCTT|GACAATTCGATTAAGCGTATGATAAACAAT
AGCAATAAACAATATCGCCGATGGGCATCC|AATTCCCACTTATGAATGCCTTATCGGTGA
CGTATCTTCATCTTATCGCATCGATAGGGG|GTATGATAAACAATATCGCCGATGGGCATC
TCATCCCAGAATTACAAGGACTAAACAATA|AGTGTAGGGTAGAATAGAAAAGCTATAGGC
ACGGTGATTGGCTCTGCATCGACGTTAGCA|CTAATATCCCAAGACTTTTGTCCGGAAATT
GATGGGCATCCTGTGTCACGCGATACGGCC|ATATCGCCGATTAAACAATATCGCCGATGG
AGGTGGAGCACTAAACAATATCGCCGATGG|AGGCTCGAGTCCCGGGGGAGAATCTTAGAA
TTCTTTGCTGCAGTGGGCCTAGTGTAGGGT|GGGGAAAAGCATTGTACGGCTCTGGCCAAA
TAAGGAAGCGGACAATTCGATTAAGCGTAT|TTTAGGTTACGGCAGAACGTGTTTATCGGC
GATGGGCATCCTGTGTTCTTTGCTGCAGTG|CTTATCGCATCGATAGGGGAAAAGCATTGT
TAAACAATATCGCCGATGGGCATCCTGTGT|CCACTTATGAATGCCTTATCGGTGAGCCCG
TGTCCGATAAACAATATCGCCGATGGGCAT|GATAGAGATCAGGGCCGGTGGTGCCGAGAA
TGATTGGCTCTGCATCGACGTTAGCAATAA|TATCCCAAGACTTTTGTCCGGAAATTCCCA
GCTATAGGCCTCACAGGCTATCCTAGCGTA|TATCGCCGATGGGCATCCTGTGTCTTGGTT
AGGCCTCACAGGCTATCCTAGCGTACGACC|CCGATGGGCATCCTGTGTCTTGGTTTTCCC
TGTGTTTGGATGGACTCTCCGGGATAGAGA|AGCAGCACCAATATATTCCCTCTAACCACG
AAGATCTTTGGGAGGGCACTATAGACGGTG|AACTGGGGGGCCGCGCAGGAGATCCTAATA
TGGGTGAGATTTTAGGTTACGGCAGAACGT|CTGTGTGGGCATAAACAATATCGCCGATGG
GCAGTGGGCCTAGTGTAGGGTAGAATAGAA|CATTGTACGGCTCTGGCCAAAACAGTAAAC
CTTATCGCATCGATAGGGGAAAAGCATTGT|AATATCGCCGATGGGCATCCTGTGTCCGCG
TCACTATAAACAATATCGCCGATGGGCATC|ATTGGCTCTGCATCGACGTTAGCAATAAAC
CCGATGGGCATCCTGTGTCATCCCAGAATT|TTTGCTGCAGTGGGCCTAGTGTAGGGTAGA
TTACTCCCTGAAGATCTTTGGGAGGGCACT|AGGGTAAATAAACTGGGGGGCCGCGCAGGA
TCCGGAAATTCCCACTTATGAATGCCTTAT|ATATCTAAACAATATCGCCGATGGGCATCC
CCCGCTATCGCTACTAAGCGAATCTATTCA|CGATGGGCATCCTGTGTTGATACTTCAGGT
GTGTGTTTACTCCCTGAAGATCTTTGGGAG|GCCAAGAGGGTAAATAAACTGGGGGGCCGC
CCACGCTTCGTGAAATGGGTTGGTCACTAT|TTGGGAGGGCACTATAGACGGTGATTGGCT
ATTTGTCTTAAACAATATCGCCGATGGGCA|CCGATGGGCATCCTGTGTTCTTTGCTGCAG
CAATGGATATGGCTCCGGACGCCAAGAGGG|CTAAGCGAATCTATTCAACCACCTAACTCA
GTCTTAAACAATATCGCCGATGGGCATCCT|TGGGCATCCTGTGTTCTTTGCTGCAGTGGG
GTTAGTAGAGCATAGCCTCAGCTTCGTAAT|TGTGAGATACTATATCTATAGTGGACTCGT
CGTGTTTATCGGCTATGACGCCTCGGCTCC|TGGGCATCCTGTGTTCCTGTGTCCGATAAA
CCCACGATGGGAAGAACCTACTACAATACC|CCCGTAAGGAAGCGGACAATTCGATTAAGC
GCGATACGGCCTGATATGGGTGAGATTTTA|ATCGCCGATGGGCATCCTGTGTGGGCATAA
GCCGATGGGCATCCTGTGTTCTTTGCTGCA|CATCTTATCGCATCGATAGGGGAAAAGCAT
ACTTCACTAGTTAGGCGTTTAGCGGGGTGT|GCCCGGCAATGGATATGGCTCCGGACGCCA
GATTAAACAATATCGCCGATGGGCATCCTG|TTCGTAATACGTTAGAGGTGGAGCACTAAA
AATATCGCCGATGGGCATCCTGTGTCACGC|AAATAAACAATATCGCCGATTAAACAATAT
GGCTCTGGCCAAAACAGTAAACAATATCGC|AGTAAACAATATCGCCGATGGGCATCCTGT
GCTTCGTAATACGTTAGAGGTGGAGCACTA|GTGGACTCGTCCTTGCTAGGCTCGAGTCCC
ATAAACAATATCGCCGATGGGCATCCTGTG|GATCAGGGCCGGTGGTGCCGAGAACTCTAT
TATCGCCGATGGGCATCCTGTGTGAAAAAC|GCCTCACAGGCTATCCTAGCGTACGACCCA
ATCGCCGATTAAACAATATCGCCGATGGGC|CTCAGCTTCGTAATACGTTAGAGGTGGAGC
CTATAGTGGACTCGTCCTTGCTAGGCTCGA|GGCATCCTGTGTTAATATCCCCATGTATCG
AAACAATATCGCCGATGGGCATCCTGTGTC|GACGCCTCGGCTCCCAAACATAAAGGTGCG
ATCGCCGATGGGCATCCTGTGTTTGGATGG|GAATCTTAGAACACTCAAGCAGCACCAATA
ACTCAAGCAGCACCAATATATTCCCTCTAA|TAGCGGGGTGTGTTTACTCCCTGAAGATCT
ATGGGCATCCTGTGTTGAGCCCGGCAATGG|TTATCGGTGAGCCCGCTATCGCTACTAAGC
TACTAAGCGAATCTATTCAACCACCTAACT|CTGTGTTGATACTTCAGGTACGTATCGAAG
CCTGTGTGAAAAACTCAACATCGCGACATA|TAGCGTACGACCCACGATGGGAAGAACCTA
CTCTCCGGGATAGAGATCAGGGCCGGTGGT|ATTCCCTCTAACCACGCTTCGTGAAATGGG
TGGGCATCCTGTGTTCCTGTGTCCGATAAA|GTTTGGATGGACTCTCCGGGATAGAGATCA
GGCATCCTGTGTCTTGGTTTTCCCCGTAAG|GCGATACGGCCTGATATGGGTGAGATTTTA
GGGCATCCTGTGTGGGCATAAACAATATCG|GAGCACTAAACAATATCGCCGATGGGCATC
TGGGCATAAACAATATCGCCGATGGGCATC|ATATCGCCGATGGGCATCCTGTGTTTGGAT
CTCAAGCAGCACCAATATATTCCCTCTAAC|AGCGGGGTGTGTTTACTCCCTGAAGATCTT
ATCTTTGGGAGGGCACTATAGACGGTGATT|TGGGGGGCCGCGCAGGAGATCCTAATATCC
GCCTCGGCTCCCAAACATAAAGGTGCGTGG|TGTCCGATAAACAATATCGCCGATGGGCAT
ACAATATCGCCGATTAAACAATATCGCCGA|ATAGCCTCAGCTTCGTAATACGTTAGAGGT
AATATCGCCGATGGGCATCCTGTGTTTGGA|GGAGAATCTTAGAACACTCAAGCAGCACCA
CATCCTGTGTTAGTAGAGCATAGCCTCAGC|GAACTCTATGTGAGATACTATATCTATAGT
AATATCGCCGATGGGCATCCTGTGTTGAGC|TATGAATGCCTTATCGGTGAGCCCGCTATC
CTAGCGTACGACCCACGATGGGAAGAACCT|TCTTGGTTTTCCCCGTAAGGAAGCGGACAA
TCCGATAAACAATATCGCCGATGGGCATCC|TAGAGATCAGGGCCGGTGGTGCCGAGAACT
GAAAAGCATTGTACGGCTCTGGCCAAAACA|CCTGTGTCCGCGAAAGTAAACAATATCGCC
TAAATAAACAATATCGCCGATTAAACAATA|GTAGAGCATAGCCTCAGCTTCGTAATACGT
CTATTCAACCACCTAACTCAGCGATTTACG|TTCAGGTACGTATCGAAGCCCTATCCGCGC
GTTTACTCCCTGAAGATCTTTGGGAGGGCA|AGAGGGTAAATAAACTGGGGGGCCGCGCAG
CCCAAACATAAAGGTGCGTGGCTCTTGCAG|AACAATATCGCCGATGGGCATCCTGTGTTA
GTTTTCCCCGTAAGGAAGCGGACAATTCGA|TGGGTGAGATTTTAGGTTACGGCAGAACGT
GCAGTAAATAAACAATATCGCCGATTAAAC|GTTAGTAGAGCATAGCCTCAGCTTCGTAAT
GATAGGGGAAAAGCATTGTACGGCTCTGGC|TGGGCATCCTGTGTCCGCGAAAGTAAACAA
TGGGCATCCTGTGTCATCCCAGAATTACAA|CTGCAGTGGGCCTAGTGTAGGGTAGAATAG
CAGAACGTGTTTATCGGCTATGACGCCTCG|GCCGATGGGCATCCTGTGTTCCTGTGTCCG
TCCCAGAATTACAAGGACTAAACAATATCG|GTAGGGTAGAATAGAAAAGCTATAGGCCTC
GTGTAGGGTAGAATAGAAAAGCTATAGGCC|CTGGCCAAAACAGTAAACAATATCGCCGAT
CCTATGTTAAACAATATCGCCGATGGGCAT|CTACAATACCCGTATCTTCATCTTATCGCA
CTAATATCCCAAGACTTTTGTCCGGAAATT|CTAGTGGTCTTCATTAAACAATATCTAAAC
AATATCGCCGATGGGCATCCTGTGTTAATA|ATCGACGTTAGCAATAAACAATATCGCCGA
TATATCTATAGTGGACTCGTCCTTGCTAGG|CGATGGGCATCCTGTGTTAATATCCCCATG
GGCTATTTGTCTTAAACAATATCGCCGATG|ATCGCCGATGGGCATCCTGTGTTCTTTGCT
TCTTCATCTTATCGCATCGATAGGGGAAAA|GATAAACAATATCGCCGATGGGCATCCTGT
ACAGTAAACAATATCGCCGATGGGCATCCT|GCCGATGGGCATCCTGTGTCACGCGATACG
CCTGTGTTAGTAGAGCATAGCCTCAGCTTC|CTCTATGTGAGATACTATATCTATAGTGGA
GTTAAACAATATCGCCGATGGGCATCCTGT|ATACCCGTATCTTCATCTTATCGCATCGAT
CCGGACGCCAAGAGGGTAAATAAACTGGGG|TCAACCACCTAACTCAGCGATTTACGTATA
GGCTCGAGTCCCGGGGGAGAATCTTAGAAC|TGTATCGTACCACTTCACTAGTTAGGCGTT
TTATGAATGCCTTATCGGTGAGCCCGCTAT|CGCCGATGGGCATCCTGTGTGCCGATGGGC
CCTGTGTTAATATCCCCATGTATCGTACCA|CAATATCGCCGATGGGCATCCTGTGTTGAG
GATGGGCATCCTGTGTGGGCATAAACAATA|GTGGAGCACTAAACAATATCGCCGATGGGC
GCTCGAGTCCCGGGGGAGAATCTTAGAACA|GTATCGTACCACTTCACTAGTTAGGCGTTT
ACTCAACATCGCGACATACCTATGTTAAAC|CACGATGGGAAGAACCTACTACAATACCCG
ATTGGCTATTTGTCTTAAACAATATCGCCG|AATATCGCCGATGGGCATCCTGTGTTCTTT
CGATAGGGGAAAAGCATTGTACGGCTCTGG|ATGGGCATCCTGTGTCCGCGAAAGTAAACA
CGCTATCGCTACTAAGCGAATCTATTCAAC|ATGGGCATCCTGTGTTGATACTTCAGGTAC
ATGGACTCTCCGGGATAGAGATCAGGGCCG|AATATATTCCCTCTAACCACGCTTCGTGAA
GTGAGATTTTAGGTTACGGCAGAACGTGTT|TGTGGGCATAAACAATATCGCCGATGGGCA
TGTCTTAAACAATATCGCCGATGGGCATCC|ATGGGCATCCTGTGTTCTTTGCTGCAGTGG
TGGGTTGGTCACTATAAACAATATCGCCGA|AGACGGTGATTGGCTCTGCATCGACGTTAG
GGGCATCCTGTGTCACGCGATACGGCCTGA|TCGCCGATTAAACAATATCGCCGATGGGCA
TGGCTCTGCATCGACGTTAGCAATAAACAA|CCAAGACTTTTGTCCGGAAATTCCCACTTA
TCTTTGGGAGGGCACTATAGACGGTGATTG|GGGGGGCCGCGCAGGAGATCCTAATATCCC
CGCCGATGGGCATCCTGTGTTTGGATGGAC|ATCTTAGAACACTCAAGCAGCACCAATATA
CCTAATATCCCAAGACTTTTGTCCGGAAAT|CCTAGTGGTCTTCATTAAACAATATCTAAA
TTAGCGGGGTGTGTTTACTCCCTGAAGATC|CTCCGGACGCCAAGAGGGTAAATAAACTGG
CGCCGATGGGCATCCTGTGTTAATATCCCC|CGTTAGCAATAAACAATATCGCCGATGGGC
TGGAGCACTAAACAATATCGCCGATGGGCA|CTCGAGTCCCGGGGGAGAATCTTAGAACAC
ATCCTGTGTTGAGCCCGGCAATGGATATGG|GTGAGCCCGCTATCGCTACTAAGCGAATCT
CCGATGGGCATCCTGTGTTGAGCCCGGCAA|GCCTTATCGGTGAGCCCGCTATCGCTACTA
GTGTGGGCATAAACAATATCGCCGATGGGC|ACAATATCGCCGATGGGCATCCTGTGTTTG
GATAGAGATCAGGGCCGGTGGTGCCGAGAA|TAACCACGCTTCGTGAAATGGGTTGGTCAC
TATCCCCATGTATCGTACCACTTCACTAGT|GATGGGCATCCTGTGTTGAGCCCGGCAATG
TATCGCCGATGGGCATCCTGTGTTCCTGTG|GCATCCTGTGTTTGGATGGACTCTCCGGGA
CAATAAACAATATCGCCGATGGGCATCCTG|TTCCCACTTATGAATGCCTTATCGGTGAGC
GAGCACTAAACAATATCGCCGATGGGCATC|CGAGTCCCGGGGGAGAATCTTAGAACACTC
CTATCGCTACTAAGCGAATCTATTCAACCA|GGGCATCCTGTGTTGATACTTCAGGTACGT
ATCCTGTGTGAAAAACTCAACATCGCGACA|CCTAGCGTACGACCCACGATGGGAAGAACC
ATTAAACAATATCGCCGATGGGCATCCTGT|TCGTAATACGTTAGAGGTGGAGCACTAAAC
ACGATGGGAAGAACCTACTACAATACCCGT|GTAAGGAAGCGGACAATTCGATTAAGCGTA
TCATCTTATCGCATCGATAGGGGAAAAGCA|AAACAATATCGCCGATGGGCATCCTGTGTC
TAGTTAGGCGTTTAGCGGGGTGTGTTTACT|AATGGATATGGCTCCGGACGCCAAGAGGGT
AACAGTAAACAATATCGCCGATGGGCATCC|CGCCGATGGGCATCCTGTGTCACGCGATAC
GGGAGGGCACTATAGACGGTGATTGGCTCT|GCCGCGCAGGAGATCCTAATATCCCAAGAC
GCATCCTGTGTTCTTTGCTGCAGTGGGCCT|CGCATCGATAGGGGAAAAGCATTGTACGGC
TGAGCCCGGCAATGGATATGGCTCCGGACG|CTATCGCTACTAAGCGAATCTATTCAACCA
GTGTTGAGCCCGGCAATGGATATGGCTCCG|CCCGCTATCGCTACTAAGCGAATCTATTCA
GTCCTTGCTAGGCTCGAGTCCCGGGGGAGA|AATATCCCCATGTATCGTACCACTTCACTA
GGCCTGATATGGGTGAGATTTTAGGTTACG|ATGGGCATCCTGTGTGGGCATAAACAATAT
CCTCTAACCACGCTTCGTGAAATGGGTTGG|AAGATCTTTGGGAGGGCACTATAGACGGTG
GGGTGAGATTTTAGGTTACGGCAGAACGTG|TGTGTGGGCATAAACAATATCGCCGATGGG
CTCACAGGCTATCCTAGCGTACGACCCACG|TGGGCATCCTGTGTCTTGGTTTTCCCCGTA
GGCATCCTGTGTTCCTGTGTCCGATAAACA|TTGGATGGACTCTCCGGGATAGAGATCAGG
CTTTGCTGCAGTGGGCCTAGTGTAGGGTAG|GGAAAAGCATTGTACGGCTCTGGCCAAAAC
TCGCCGATGGGCATCCTGTGTTAATATCCC|ACGTTAGCAATAAACAATATCGCCGATGGG
TGTGTTAGTAGAGCATAGCCTCAGCTTCGT|CTATGTGAGATACTATATCTATAGTGGACT
TTCGTGAAATGGGTTGGTCACTATAAACAA|GGGCACTATAGACGGTGATTGGCTCTGCAT
GCATCGACGTTAGCAATAAACAATATCGCC|TTTTGTCCGGAAATTCCCACTTATGAATGC
GGCTATGACGCCTCGGCTCCCAAACATAAA|GTGTTCCTGTGTCCGATAAACAATATCGCC
GCGACATACCTATGTTAAACAATATCGCCG|AGAACCTACTACAATACCCGTATCTTCATC
ATATCGCCGATGGGCATCCTGTGTTAATAT|TCGACGTTAGCAATAAACAATATCGCCGAT
AGAACGTGTTTATCGGCTATGACGCCTCGG|CCGATGGGCATCCTGTGTTCCTGTGTCCGA
GATACGGCCTGATATGGGTGAGATTTTAGG|CGCCGATGGGCATCCTGTGTGGGCATAAAC
AAAGCTATAGGCCTCACAGGCTATCCTAGC|CAATATCGCCGATGGGCATCCTGTGTCTTG
TGTGTTTACTCCCTGAAGATCTTTGGGAGG|CCAAGAGGGTAAATAAACTGGGGGGCCGCG
AGGGCCGGTGGTGCCGAGAACTCTATGTGA|TCGTGAAATGGGTTGGTCACTATAAACAAT
CCCGGGGGAGAATCTTAGAACACTCAAGCA|CCACTTCACTAGTTAGGCGTTTAGCGGGGT
ACTATATCTATAGTGGACTCGTCCTTGCTA|GCCGATGGGCATCCTGTGTTAATATCCCCA
AAAACTCAACATCGCGACATACCTATGTTA|ACCCACGATGGGAAGAACCTACTACAATAC
CTAGTTAGGCGTTTAGCGGGGTGTGTTTAC|CAATGGATATGGCTCCGGACGCCAAGAGGG
CAATACCCGTATCTTCATCTTATCGCATCG|ATTAAGCGTATGATAAACAATATCGCCGAT
GATGGGCATCCTGTGTTAATATCCCCATGT|AGCAATAAACAATATCGCCGATGGGCATCC
TCGATTAAGCGTATGATAAACAATATCGCC|ACGTGTTTATCGGCTATGACGCCTCGGCTC
CAATATCGCCGATGGGCATCCTGTGTCATC|CTGTGTTCTTTGCTGCAGTGGGCCTAGTGT
GTACGACCCACGATGGGAAGAACCTACTAC|GTTTTCCCCGTAAGGAAGCGGACAATTCGA
GTCATCCCAGAATTACAAGGACTAAACAAT|TAGTGTAGGGTAGAATAGAAAAGCTATAGG
TCCTGTGTCACGCGATACGGCCTGATATGG|GATTAAACAATATCGCCGATGGGCATCCTG
CAATATATTCCCTCTAACCACGCTTCGTGA|TTACTCCCTGAAGATCTTTGGGAGGGCACT
TGGTTTTCCCCGTAAGGAAGCGGACAATTC|TATGGGTGAGATTTTAGGTTACGGCAGAAC
CGGACGCCAAGAGGGTAAATAAACTGGGGG|CAACCACCTAACTCAGCGATTTACGTATAG
CGGAAATTCCCACTTATGAATGCCTTATCG|ATCTAAACAATATCGCCGATGGGCATCCTG
AACAATATCGCCGATGGGCATCCTGTGTCT|GGGCATCCTGTGTCACGCGATACGGCCTGA
ACACTCAAGCAGCACCAATATATTCCCTCT|TTTAGCGGGGTGTGTTTACTCCCTGAAGAT
AGAACTCTATGTGAGATACTATATCTATAG|TCACTATAAACAATATCGCCGATGGGCATC
AGATACTATATCTATAGTGGACTCGTCCTT|TATCGCCGATGGGCATCCTGTGTTAATATC
GAAAGTAAACAATATCGCCGATGGGCATCC|CTCTTGCAGTAAATAAACAATATCGCCGAT
ATACTATATCTATAGTGGACTCGTCCTTGC|TCGCCGATGGGCATCCTGTGTTAATATCCC
TCGCATCGATAGGGGAAAAGCATTGTACGG|TCGCCGATGGGCATCCTGTGTCCGCGAAAG
GGAGCACTAAACAATATCGCCGATGGGCAT|TCGAGTCCCGGGGGAGAATCTTAGAACACT
TCGCCGATGGGCATCCTGTGTCATCCCAGA|TTCTTTGCTGCAGTGGGCCTAGTGTAGGGT
TATCGGTGAGCCCGCTATCGCTACTAAGCG|TCCTGTGTGCCGATGGGCATCCTGTGTTGA
GCCCGCTATCGCTACTAAGCGAATCTATTC|CCGATGGGCATCCTGTGTTGATACTTCAGG
TGGCTCTTGCAGTAAATAAACAATATCGCC|CATCCTGTGTTAGTAGAGCATAGCCTCAGC
ACCACGCTTCGTGAAATGGGTTGGTCACTA|TTTGGGAGGGCACTATAGACGGTGATTGGC
GCCGATGGGCATCCTGTGTCACGCGATACG|ACAATATCGCCGATTAAACAATATCGCCGA
CGCCGATGGGCATCCTGTGTCACGCGATAC|AACAATATCGCCGATTAAACAATATCGCCG
ATGGGCATCCTGTGTGGGCATAAACAATAT|TGGAGCACTAAACAATATCGCCGATGGGCA
GAGCATAGCCTCAGCTTCGTAATACGTTAG|TACTATATCTATAGTGGACTCGTCCTTGCT
ATCCTGTGTTAATATCCCCATGTATCGTAC|AACAATATCGCCGATGGGCATCCTGTGTTG
ATCCTGTGTGGGCATAAACAATATCGCCGA|ACTAAACAATATCGCCGATGGGCATCCTGT
ATCGCCGATGGGCATCCTGTGTCCGCGAAA|CGGCTCCCAAACATAAAGGTGCGTGGCTCT
CAGTGGGCCTAGTGTAGGGTAGAATAGAAA|ATTGTACGGCTCTGGCCAAAACAGTAAACA
GTGCCGAGAACTCTATGTGAGATACTATAT|GGTTGGTCACTATAAACAATATCGCCGATG
CACTCAAGCAGCACCAATATATTCCCTCTA|TTAGCGGGGTGTGTTTACTCCCTGAAGATC
GGCATCCTGTGTGGGCATAAACAATATCGC|AGCACTAAACAATATCGCCGATGGGCATCC
GGACTCGTCCTTGCTAGGCTCGAGTCCCGG|TGTGTTAATATCCCCATGTATCGTACCACT
GGTGATTGGCTCTGCATCGACGTTAGCAAT|AATATCCCAAGACTTTTGTCCGGAAATTCC
CAATATCGCCGATGGGCATCCTGTGTTGAG|TTATGAATGCCTTATCGGTGAGCCCGCTAT
CTCCGGACGCCAAGAGGGTAAATAAACTGG|ATTCAACCACCTAACTCAGCGATTTACGTA
TCTGCATCGACGTTAGCAATAAACAATATC|GACTTTTGTCCGGAAATTCCCACTTATGAA
TCAGGGCCGGTGGTGCCGAGAACTCTATGT|CTTCGTGAAATGGGTTGGTCACTATAAACA
ATGATAAACAATATCGCCGATGGGCATCCT|GCTATGACGCCTCGGCTCCCAAACATAAAG
ATACCCGTATCTTCATCTTATCGCATCGAT|TAAGCGTATGATAAACAATATCGCCGATGG
CGCGAAAGTAAACAATATCGCCGATGGGCA|TGGCTCTTGCAGTAAATAAACAATATCGCC
TGTGTTAATATCCCCATGTATCGTACCACT|ATATCGCCGATGGGCATCCTGTGTTGAGCC
TCCCCATGTATCGTACCACTTCACTAGTTA|TGGGCATCCTGTGTTGAGCCCGGCAATGGA
GCACTAAACAATATCGCCGATGGGCATCCT|AGTCCCGGGGGAGAATCTTAGAACACTCAA
GCAGGAGATCCTAATATCCCAAGACTTTTG|CGATGACTTCCTAGTGGTCTTCATTAAACA
TCGGCTCCCAAACATAAAGGTGCGTGGCTC|CCGATAAACAATATCGCCGATGGGCATCCT
CAATATCGCCGATGGGCATCCTGTGTGGGC|TACGTTAGAGGTGGAGCACTAAACAATATC
GGGAAAAGCATTGTACGGCTCTGGCCAAAA|ATCCTGTGTCCGCGAAAGTAAACAATATCG
AAGCAGCACCAATATATTCCCTCTAACCAC|GGGGTGTGTTTACTCCCTGAAGATCTTTGG
ATGAATGCCTTATCGGTGAGCCCGCTATCG|CCGATGGGCATCCTGTGTGCCGATGGGCAT
AAAAACTCAACATCGCGACATACCTATGTT|GACCCACGATGGGAAGAACCTACTACAATA
GCATTGTACGGCTCTGGCCAAAACAGTAAA|GTCCGCGAAAGTAAACAATATCGCCGATGG
TCGGTGAGCCCGCTATCGCTACTAAGCGAA|CTGTGTGCCGATGGGCATCCTGTGTTGATA
TGGGCATCCTGTGTTAATATCCCCATGTAT|CAATAAACAATATCGCCGATGGGCATCCTG
TCGCTACTAAGCGAATCTATTCAACCACCT|CATCCTGTGTTGATACTTCAGGTACGTATC
CTGCATCGACGTTAGCAATAAACAATATCG|ACTTTTGTCCGGAAATTCCCACTTATGAAT
TGTTAATATCCCCATGTATCGTACCACTTC|ATCGCCGATGGGCATCCTGTGTTGAGCCCG
TGTCACGCGATACGGCCTGATATGGGTGAG|AACAATATCGCCGATGGGCATCCTGTGTGG
ATATGGGTGAGATTTTAGGTTACGGCAGAA|ATCCTGTGTGGGCATAAACAATATCGCCGA
TTAAACAATATCGCCGATGGGCATCCTGTG|TACCCGTATCTTCATCTTATCGCATCGATA
GAATTGGCTATTTGTCTTAAACAATATCGC|ACAATATCGCCGATGGGCATCCTGTGTTCT
TTAATATCCCCATGTATCGTACCACTTCAC|CGCCGATGGGCATCCTGTGTTGAGCCCGGC
GTGAGCCCGCTATCGCTACTAAGCGAATCT|TGTGCCGATGGGCATCCTGTGTTGATACTT
CCCATGTATCGTACCACTTCACTAGTTAGG|GGCATCCTGTGTTGAGCCCGGCAATGGATA
CAGAATTACAAGGACTAAACAATATCGCCG|GGGTAGAATAGAAAAGCTATAGGCCTCACA
CCCACTTATGAATGCCTTATCGGTGAGCCC|AATATCGCCGATGGGCATCCTGTGTGCCGA
CCTACTACAATACCCGTATCTTCATCTTAT|CAATTCGATTAAGCGTATGATAAACAATAT
AACAATATCGCCGATGGGCATCCTGTGTTT|GGGGGAGAATCTTAGAACACTCAAGCAGCA
CTTCGTAATACGTTAGAGGTGGAGCACTAA|TGGACTCGTCCTTGCTAGGCTCGAGTCCCG
TCGCCGATGGGCATCCTGTGTTAGTAGAGC|GGTGGTGCCGAGAACTCTATGTGAGATACT
ATCGACGTTAGCAATAAACAATATCGCCGA|TTGTCCGGAAATTCCCACTTATGAATGCCT
AGAAAAGCTATAGGCCTCACAGGCTATCCT|AAACAATATCGCCGATGGGCATCCTGTGTC
TAAACAATATCGCCGATGGGCATCCTGTGT|GCAGTAAATAAACAATATCGCCGATTAAAC
ATCGGCTATGACGCCTCGGCTCCCAAACAT|CCTGTGTTCCTGTGTCCGATAAACAATATC
CTCTAACCACGCTTCGTGAAATGGGTTGGT|AGATCTTTGGGAGGGCACTATAGACGGTGA
GGTTACGGCAGAACGTGTTTATCGGCTATG|ACAATATCGCCGATGGGCATCCTGTGTTCC
TTTTCCCCGTAAGGAAGCGGACAATTCGAT|GGGTGAGATTTTAGGTTACGGCAGAACGTG
CTCGAGTCCCGGGGGAGAATCTTAGAACAC|TATCGTACCACTTCACTAGTTAGGCGTTTA
TCTCCGGGATAGAGATCAGGGCCGGTGGTG|TTCCCTCTAACCACGCTTCGTGAAATGGGT
CCAATATATTCCCTCTAACCACGCTTCGTG|TTTACTCCCTGAAGATCTTTGGGAGGGCAC
TCGAGTCCCGGGGGAGAATCTTAGAACACT|ATCGTACCACTTCACTAGTTAGGCGTTTAG
CAGGCTATCCTAGCGTACGACCCACGATGG|CATCCTGTGTCTTGGTTTTCCCCGTAAGGA
TCTTTGCTGCAGTGGGCCTAGTGTAGGGTA|GGGAAAAGCATTGTACGGCTCTGGCCAAAA
ATAGAAAAGCTATAGGCCTCACAGGCTATC|GTAAACAATATCGCCGATGGGCATCCTGTG
GATTAAGCGTATGATAAACAATATCGCCGA|GTGTTTATCGGCTATGACGCCTCGGCTCCC
TGAGATTTTAGGTTACGGCAGAACGTGTTT|GTGGGCATAAACAATATCGCCGATGGGCAT
TGGCCAAAACAGTAAACAATATCGCCGATG|ACAATATCGCCGATGGGCATCCTGTGTCAC
GGGGGAGAATCTTAGAACACTCAAGCAGCA|CTTCACTAGTTAGGCGTTTAGCGGGGTGTG
ATATCGCCGATGGGCATCCTGTGTCACGCG|AATAAACAATATCGCCGATTAAACAATATC
CTATATCTATAGTGGACTCGTCCTTGCTAG|CCGATGGGCATCCTGTGTTAATATCCCCAT
GGTTTTCCCCGTAAGGAAGCGGACAATTCG|ATGGGTGAGATTTTAGGTTACGGCAGAACG
GGCAGAACGTGTTTATCGGCTATGACGCCT|TCGCCGATGGGCATCCTGTGTTCCTGTGTC
TCTATAGTGGACTCGTCCTTGCTAGGCTCG|GGGCATCCTGTGTTAATATCCCCATGTATC
CTTGCAGTAAATAAACAATATCGCCGATTA|TGTGTTAGTAGAGCATAGCCTCAGCTTCGT
TTTGGGAGGGCACTATAGACGGTGATTGGC|GGGGCCGCGCAGGAGATCCTAATATCCCAA
GGCATCCTGTGTTTGGATGGACTCTCCGGG|ACACTCAAGCAGCACCAATATATTCCCTCT
GGGGGCCGCGCAGGAGATCCTAATATCCCA|ATAGTCCACCGATGACTTCCTAGTGGTCTT
GAGAATCTTAGAACACTCAAGCAGCACCAA|ACTAGTTAGGCGTTTAGCGGGGTGTGTTTA
TAGAGATCAGGGCCGGTGGTGCCGAGAACT|ACCACGCTTCGTGAAATGGGTTGGTCACTA
CATCCTGTGTCACGCGATACGGCCTGATAT|CCGATTAAACAATATCGCCGATGGGCATCC
GCATCCTGTGTGGGCATAAACAATATCGCC|GCACTAAACAATATCGCCGATGGGCATCCT
GGCATCCTGTGTTAATATCCCCATGTATCG|ATAAACAATATCGCCGATGGGCATCCTGTG
AATTCGATTAAGCGTATGATAAACAATATC|AGAACGTGTTTATCGGCTATGACGCCTCGG
CGTATGATAAACAATATCGCCGATGGGCAT|TCGGCTATGACGCCTCGGCTCCCAAACATA
GGGGAGAATCTTAGAACACTCAAGCAGCAC|TTCACTAGTTAGGCGTTTAGCGGGGTGTGT
GCCGATTAAACAATATCGCCGATGGGCATC|AGCTTCGTAATACGTTAGAGGTGGAGCACT
GCTCTGGCCAAAACAGTAAACAATATCGCC|GTAAACAATATCGCCGATGGGCATCCTGTG
TTTAGGTTACGGCAGAACGTGTTTATCGGC|ATAAACAATATCGCCGATGGGCATCCTGTG
AAAAGCATTGTACGGCTCTGGCCAAAACAG|CTGTGTCCGCGAAAGTAAACAATATCGCCG
TAAACAATATCGCCGATGGGCATCCTGTGT|TGACGCCTCGGCTCCCAAACATAAAGGTGC
GAGATCCTAATATCCCAAGACTTTTGTCCG|GACTTCCTAGTGGTCTTCATTAAACAATAT
CGATAAACAATATCGCCGATGGGCATCCTG|GAGATCAGGGCCGGTGGTGCCGAGAACTCT
GCATCCTGTGTCCGCGAAAGTAAACAATAT|CATAAAGGTGCGTGGCTCTTGCAGTAAATA
TACGTTAGAGGTGGAGCACTAAACAATATC|TCCTTGCTAGGCTCGAGTCCCGGGGGAGAA
CAAAACAGTAAACAATATCGCCGATGGGCA|TATCGCCGATGGGCATCCTGTGTCACGCGA
GCACTATAGACGGTGATTGGCTCTGCATCG|CAGGAGATCCTAATATCCCAAGACTTTTGT
TAGTAGAGCATAGCCTCAGCTTCGTAATAC|TGAGATACTATATCTATAGTGGACTCGTCC
TCGGCTATGACGCCTCGGCTCCCAAACATA|CTGTGTTCCTGTGTCCGATAAACAATATCG
AGAATCTTAGAACACTCAAGCAGCACCAAT|CTAGTTAGGCGTTTAGCGGGGTGTGTTTAC
TCTAACCACGCTTCGTGAAATGGGTTGGTC|GATCTTTGGGAGGGCACTATAGACGGTGAT
GCAGCACCAATATATTCCCTCTAACCACGC|GGTGTGTTTACTCCCTGAAGATCTTTGGGA
GCAGAACGTGTTTATCGGCTATGACGCCTC|CGCCGATGGGCATCCTGTGTTCCTGTGTCC
TGTGTTCCTGTGTCCGATAAACAATATCGC|GACTCTCCGGGATAGAGATCAGGGCCGGTG
CTCTGCATCGACGTTAGCAATAAACAATAT|AGACTTTTGTCCGGAAATTCCCACTTATGA
CTCTATGTGAGATACTATATCTATAGTGGA|TATAAACAATATCGCCGATGGGCATCCTGT
GTCCCGGGGGAGAATCTTAGAACACTCAAG|TACCACTTCACTAGTTAGGCGTTTAGCGGG
GTAGAGCATAGCCTCAGCTTCGTAATACGT|AGATACTATATCTATAGTGGACTCGTCCTT
CTGTGTTAGTAGAGCATAGCCTCAGCTTCG|TCTATGTGAGATACTATATCTATAGTGGAC
TTGCTAGGCTCGAGTCCCGGGGGAGAATCT|TCCCCATGTATCGTACCACTTCACTAGTTA
TAGACGGTGATTGGCTCTGCATCGACGTTA|ATCCTAATATCCCAAGACTTTTGTCCGGAA
ATGCCTTATCGGTGAGCCCGCTATCGCTAC|TGGGCATCCTGTGTGCCGATGGGCATCCTG
CGAGAACTCTATGTGAGATACTATATCTAT|GGTCACTATAAACAATATCGCCGATGGGCA
CCCGGCAATGGATATGGCTCCGGACGCCAA|CGCTACTAAGCGAATCTATTCAACCACCTA
AGTGTAGGGTAGAATAGAAAAGCTATAGGC|TCTGGCCAAAACAGTAAACAATATCGCCGA
TCCTAATATCCCAAGACTTTTGTCCGGAAA|TCCTAGTGGTCTTCATTAAACAATATCTAA
CCACTTCACTAGTTAGGCGTTTAGCGGGGT|GAGCCCGGCAATGGATATGGCTCCGGACGC
GAATAGAAAAGCTATAGGCCTCACAGGCTA|CAGTAAACAATATCGCCGATGGGCATCCTG
ATAGTGGACTCGTCCTTGCTAGGCTCGAGT|CATCCTGTGTTAATATCCCCATGTATCGTA
ATATCGCCGATGGGCATCCTGTGTTCTTTG|ATCTTCATCTTATCGCATCGATAGGGGAAA
TACCCGTATCTTCATCTTATCGCATCGATA|AAGCGTATGATAAACAATATCGCCGATGGG
TGGTGCCGAGAACTCTATGTGAGATACTAT|TGGGTTGGTCACTATAAACAATATCGCCGA
TGTATCGTACCACTTCACTAGTTAGGCGTT|TCCTGTGTTGAGCCCGGCAATGGATATGGC
TGGGCATCCTGTGTTTGGATGGACTCTCCG|GAACACTCAAGCAGCACCAATATATTCCCT
TTGCTGCAGTGGGCCTAGTGTAGGGTAGAA|AAAAGCATTGTACGGCTCTGGCCAAAACAG
GTTTGGATGGACTCTCCGGGATAGAGATCA|AGCACCAATATATTCCCTCTAACCACGCTT
CGATGGGCATCCTGTGTCCGCGAAAGTAAA|CCCAAACATAAAGGTGCGTGGCTCTTGCAG
GGCCAAAACAGTAAACAATATCGCCGATGG|CAATATCGCCGATGGGCATCCTGTGTCACG
ATATCGCCGATGGGCATCCTGTGTCTTGGT|ATCCTGTGTCACGCGATACGGCCTGATATG
GTAGAATAGAAAAGCTATAGGCCTCACAGG|AAACAGTAAACAATATCGCCGATGGGCATC
ATGAATTGGCTATTTGTCTTAAACAATATC|AAACAATATCGCCGATGGGCATCCTGTGTT
ATCCTGTGTTCTTTGCTGCAGTGGGCCTAG|CATCGATAGGGGAAAAGCATTGTACGGCTC
TTAGCAATAAACAATATCGCCGATGGGCAT|GAAATTCCCACTTATGAATGCCTTATCGGT
CCAAAACAGTAAACAATATCGCCGATGGGC|ATATCGCCGATGGGCATCCTGTGTCACGCG
ATTGTACGGCTCTGGCCAAAACAGTAAACA|CCGCGAAAGTAAACAATATCGCCGATGGGC
GGTAGAATAGAAAAGCTATAGGCCTCACAG|AAAACAGTAAACAATATCGCCGATGGGCAT
TCCCAAACATAAAGGTGCGTGGCTCTTGCA|AAACAATATCGCCGATGGGCATCCTGTGTT
CGAATCTATTCAACCACCTAACTCAGCGAT|GATACTTCAGGTACGTATCGAAGCCCTATC
ATCCCCATGTATCGTACCACTTCACTAGTT|ATGGGCATCCTGTGTTGAGCCCGGCAATGG
ACAATATCGCCGATGGGCATCCTGTGTTCT|CGTATCTTCATCTTATCGCATCGATAGGGG
CTTATGAATGCCTTATCGGTGAGCCCGCTA|TCGCCGATGGGCATCCTGTGTGCCGATGGG
AGAGATCAGGGCCGGTGGTGCCGAGAACTC|CCACGCTTCGTGAAATGGGTTGGTCACTAT
CTAGGCTCGAGTCCCGGGGGAGAATCTTAG|CCATGTATCGTACCACTTCACTAGTTAGGC
TATCGTACCACTTCACTAGTTAGGCGTTTA|CTGTGTTGAGCCCGGCAATGGATATGGCTC
ACAATACCCGTATCTTCATCTTATCGCATC|GATTAAGCGTATGATAAACAATATCGCCGA
GCTCTTGCAGTAAATAAACAATATCGCCGA|TCCTGTGTTAGTAGAGCATAGCCTCAGCTT
GCATCCTGTGTCATCCCAGAATTACAAGGA|CAGTGGGCCTAGTGTAGGGTAGAATAGAAA
ATCTTCATCTTATCGCATCGATAGGGGAAA|TGATAAACAATATCGCCGATGGGCATCCTG
AAACAATATCGCCGATTAAACAATATCGCC|GCATAGCCTCAGCTTCGTAATACGTTAGAG
AAGCGTATGATAAACAATATCGCCGATGGG|TTATCGGCTATGACGCCTCGGCTCCCAAAC
TTTACTCCCTGAAGATCTTTGGGAGGGCAC|GAGGGTAAATAAACTGGGGGGCCGCGCAGG
GCTCCCAAACATAAAGGTGCGTGGCTCTTG|ATAAACAATATCGCCGATGGGCATCCTGTG
ACAAGGACTAAACAATATCGCCGATGGGCA|ATAGAAAAGCTATAGGCCTCACAGGCTATC
TGCATCGACGTTAGCAATAAACAATATCGC|CTTTTGTCCGGAAATTCCCACTTATGAATG
TCTTAGAACACTCAAGCAGCACCAATATAT|TTAGGCGTTTAGCGGGGTGTGTTTACTCCC
GCGTATGATAAACAATATCGCCGATGGGCA|ATCGGCTATGACGCCTCGGCTCCCAAACAT
TGATAAACAATATCGCCGATGGGCATCCTG|CTATGACGCCTCGGCTCCCAAACATAAAGG
CATCCTGTGTTCCTGTGTCCGATAAACAAT|GGATGGACTCTCCGGGATAGAGATCAGGGC
TTTGTCTTAAACAATATCGCCGATGGGCAT|CGATGGGCATCCTGTGTTCTTTGCTGCAGT
GCATAGCCTCAGCTTCGTAATACGTTAGAG|CTATATCTATAGTGGACTCGTCCTTGCTAG
CTTGCTAGGCTCGAGTCCCGGGGGAGAATC|ATCCCCATGTATCGTACCACTTCACTAGTT
GCCGATGGGCATCCTGTGTTTGGATGGACT|TCTTAGAACACTCAAGCAGCACCAATATAT
TCCGGACGCCAAGAGGGTAAATAAACTGGG|TTCAACCACCTAACTCAGCGATTTACGTAT
GCATCCTGTGTTAGTAGAGCATAGCCTCAG|AGAACTCTATGTGAGATACTATATCTATAG
TATCGCATCGATAGGGGAAAAGCATTGTAC|TATCGCCGATGGGCATCCTGTGTCCGCGAA
GCCTAGTGTAGGGTAGAATAGAAAAGCTAT|CGGCTCTGGCCAAAACAGTAAACAATATCG
TAAAGGTGCGTGGCTCTTGCAGTAAATAAA|CGCCGATGGGCATCCTGTGTTAGTAGAGCA
CTATAGACGGTGATTGGCTCTGCATCGACG|GAGATCCTAATATCCCAAGACTTTTGTCCG
AGAGGGTAAATAAACTGGGGGGCCGCGCAG|AACTCAGCGATTTACGTATAGTCCACCGAT
TAAACAATATCGCCGATGGGCATCCTGTGT|ATCAGGGCCGGTGGTGCCGAGAACTCTATG
TTAGTAGAGCATAGCCTCAGCTTCGTAATA|GTGAGATACTATATCTATAGTGGACTCGTC
GACTTTTGTCCGGAAATTCCCACTTATGAA|ATTAAACAATATCTAAACAATATCGCCGAT
AATATCGCCGATGGGCATCCTGTGTTCTTT|TATCTTCATCTTATCGCATCGATAGGGGAA
GTGGTGCCGAGAACTCTATGTGAGATACTA|ATGGGTTGGTCACTATAAACAATATCGCCG
ACGCCTCGGCTCCCAAACATAAAGGTGCGT|TGTGTCCGATAAACAATATCGCCGATGGGC
TTAGGCGTTTAGCGGGGTGTGTTTACTCCC|GGATATGGCTCCGGACGCCAAGAGGGTAAA
ATAAACAATATCGCCGATGGGCATCCTGTG|ATGACGCCTCGGCTCCCAAACATAAAGGTG
TCCTGTGTCTTGGTTTTCCCCGTAAGGAAG|TACGGCCTGATATGGGTGAGATTTTAGGTT
GGGCATCCTGTGTTTGGATGGACTCTCCGG|AACACTCAAGCAGCACCAATATATTCCCTC
GAGATTTTAGGTTACGGCAGAACGTGTTTA|TGGGCATAAACAATATCGCCGATGGGCATC
TGTACGGCTCTGGCCAAAACAGTAAACAAT|GCGAAAGTAAACAATATCGCCGATGGGCAT
TAATATCCCAAGACTTTTGTCCGGAAATTC|TAGTGGTCTTCATTAAACAATATCTAAACA
TGAATTGGCTATTTGTCTTAAACAATATCG|AACAATATCGCCGATGGGCATCCTGTGTTC
CAATATCGCCGATGGGCATCCTGTGTTTGG|GGGAGAATCTTAGAACACTCAAGCAGCACC
CACGATGGGAAGAACCTACTACAATACCCG|CGTAAGGAAGCGGACAATTCGATTAAGCGT
CCTGTGTTGAGCCCGGCAATGGATATGGCT|GAGCCCGCTATCGCTACTAAGCGAATCTAT
TTGTCCGGAAATTCCCACTTATGAATGCCT|ACAATATCTAAACAATATCGCCGATGGGCA
TGCGTGGCTCTTGCAGTAAATAAACAATAT|TGGGCATCCTGTGTTAGTAGAGCATAGCCT
TGTGTCACGCGATACGGCCTGATATGGGTG|TAAACAATATCGCCGATGGGCATCCTGTGT
AATAAACAATATCGCCGATTAAACAATATC|AGAGCATAGCCTCAGCTTCGTAATACGTTA
ATGGGAAGAACCTACTACAATACCCGTATC|AGGAAGCGGACAATTCGATTAAGCGTATGA
TAGGCGTTTAGCGGGGTGTGTTTACTCCCT|GATATGGCTCCGGACGCCAAGAGGGTAAAT
CTGATATGGGTGAGATTTTAGGTTACGGCA|GGCATCCTGTGTGGGCATAAACAATATCGC
GCCGATGGGCATCCTGTGTTCCTGTGTCCG|CCTGTGTTTGGATGGACTCTCCGGGATAGA
AATGGGTTGGTCACTATAAACAATATCGCC|ATAGACGGTGATTGGCTCTGCATCGACGTT
TGGGCATCCTGTGTTCTTTGCTGCAGTGGG|TATCGCATCGATAGGGGAAAAGCATTGTAC
CGCATCGATAGGGGAAAAGCATTGTACGGC|CGCCGATGGGCATCCTGTGTCCGCGAAAGT
TGTCATCCCAGAATTACAAGGACTAAACAA|CTAGTGTAGGGTAGAATAGAAAAGCTATAG
TAAACAATATCGCCGATGGGCATCCTGTGT|GCTATAGGCCTCACAGGCTATCCTAGCGTA
TTTGCTGCAGTGGGCCTAGTGTAGGGTAGA|GAAAAGCATTGTACGGCTCTGGCCAAAACA
TCGCCGATGGGCATCCTGTGTGAAAAACTC|CTCACAGGCTATCCTAGCGTACGACCCACG
GGAGATCCTAATATCCCAAGACTTTTGTCC|TGACTTCCTAGTGGTCTTCATTAAACAATA
GAAAAACTCAACATCGCGACATACCTATGT|CGACCCACGATGGGAAGAACCTACTACAAT
ACAATATCGCCGATGGGCATCCTGTGTGGG|ATACGTTAGAGGTGGAGCACTAAACAATAT
TATGTTAAACAATATCGCCGATGGGCATCC|ACAATACCCGTATCTTCATCTTATCGCATC
CGCCGATGGGCATCCTGTGTTAGTAGAGCA|GTGGTGCCGAGAACTCTATGTGAGATACTA
GATCTTTGGGAGGGCACTATAGACGGTGAT|CTGGGGGGCCGCGCAGGAGATCCTAATATC
GGCATCCTGTGTCCGCGAAAGTAAACAATA|ACATAAAGGTGCGTGGCTCTTGCAGTAAAT
TGCTAGGCTCGAGTCCCGGGGGAGAATCTT|CCCCATGTATCGTACCACTTCACTAGTTAG
TGACGCCTCGGCTCCCAAACATAAAGGTGC|CCTGTGTCCGATAAACAATATCGCCGATGG
ACGACCCACGATGGGAAGAACCTACTACAA|TTTCCCCGTAAGGAAGCGGACAATTCGATT
TGCTGCAGTGGGCCTAGTGTAGGGTAGAAT|AAAGCATTGTACGGCTCTGGCCAAAACAGT
ATGGGTTGGTCACTATAAACAATATCGCCG|TAGACGGTGATTGGCTCTGCATCGACGTTA
CTACAATACCCGTATCTTCATCTTATCGCA|TCGATTAAGCGTATGATAAACAATATCGCC
CCGCGCAGGAGATCCTAATATCCCAAGACT|CCACCGATGACTTCCTAGTGGTCTTCATTA
CCCCGTAAGGAAGCGGACAATTCGATTAAG|GAGATTTTAGGTTACGGCAGAACGTGTTTA
TCCTGTGTTCCTGTGTCCGATAAACAATAT|ATGGACTCTCCGGGATAGAGATCAGGGCCG
TTCCCTCTAACCACGCTTCGTGAAATGGGT|CTGAAGATCTTTGGGAGGGCACTATAGACG
GCGCAGGAGATCCTAATATCCCAAGACTTT|ACCGATGACTTCCTAGTGGTCTTCATTAAA
GAGGGCACTATAGACGGTGATTGGCTCTGC|CGCGCAGGAGATCCTAATATCCCAAGACTT
AACAATATCGCCGATGGGCATCCTGTGTTC|CCGTATCTTCATCTTATCGCATCGATAGGG
CGTAAGGAAGCGGACAATTCGATTAAGCGT|ATTTTAGGTTACGGCAGAACGTGTTTATCG
ACAATATCGCCGATGGGCATCCTGTGTTCC|ATGGGCATCCTGTGTTTGGATGGACTCTCC
CTGTGTCATCCCAGAATTACAAGGACTAAA|GGCCTAGTGTAGGGTAGAATAGAAAAGCTA
TTGCAGTAAATAAACAATATCGCCGATTAA|GTGTTAGTAGAGCATAGCCTCAGCTTCGTA
ATGGGCATCCTGTGTTTGGATGGACTCTCC|AGAACACTCAAGCAGCACCAATATATTCCC
CATACCTATGTTAAACAATATCGCCGATGG|CCTACTACAATACCCGTATCTTCATCTTAT
AGGTGCGTGGCTCTTGCAGTAAATAAACAA|CGATGGGCATCCTGTGTTAGTAGAGCATAG
AATCTATTCAACCACCTAACTCAGCGATTT|TACTTCAGGTACGTATCGAAGCCCTATCCG
GGAAGCGGACAATTCGATTAAGCGTATGAT|AGGTTACGGCAGAACGTGTTTATCGGCTAT
AGCACTAAACAATATCGCCGATGGGCATCC|GAGTCCCGGGGGAGAATCTTAGAACACTCA
TATCGCTACTAAGCGAATCTATTCAACCAC|GGCATCCTGTGTTGATACTTCAGGTACGTA
CGGGGGAGAATCTTAGAACACTCAAGCAGC|ACTTCACTAGTTAGGCGTTTAGCGGGGTGT
ACAATATCGCCGATGGGCATCCTGTGTCCG|CGCCTCGGCTCCCAAACATAAAGGTGCGTG
GTGAAATGGGTTGGTCACTATAAACAATAT|CACTATAGACGGTGATTGGCTCTGCATCGA
TGAATGCCTTATCGGTGAGCCCGCTATCGC|CGATGGGCATCCTGTGTGCCGATGGGCATC
TAAATAAACTGGGGGGCCGCGCAGGAGATC|GCGATTTACGTATAGTCCACCGATGACTTC
ATATCTATAGTGGACTCGTCCTTGCTAGGC|GATGGGCATCCTGTGTTAATATCCCCATGT
ACTAGTTAGGCGTTTAGCGGGGTGTGTTTA|GCAATGGATATGGCTCCGGACGCCAAGAGG
ATCCTGTGTTCCTGTGTCCGATAAACAATA|GATGGACTCTCCGGGATAGAGATCAGGGCC
ATTAAGCGTATGATAAACAATATCGCCGAT|TGTTTATCGGCTATGACGCCTCGGCTCCCA
CCTGTGTCCGCGAAAGTAAACAATATCGCC|AAGGTGCGTGGCTCTTGCAGTAAATAAACA
AACCACCTAACTCAGCGATTTACGTATAGT|TACGTATCGAAGCCCTATCCGCGCGACTTT
AGCGGACAATTCGATTAAGCGTATGATAAA|TTACGGCAGAACGTGTTTATCGGCTATGAC
AATATCCCCATGTATCGTACCACTTCACTA|CCGATGGGCATCCTGTGTTGAGCCCGGCAA
ATCCCAAGACTTTTGTCCGGAAATTCCCAC|GGTCTTCATTAAACAATATCTAAACAATAT
ATTCCCTCTAACCACGCTTCGTGAAATGGG|CCTGAAGATCTTTGGGAGGGCACTATAGAC
CTGTGTTTGGATGGACTCTCCGGGATAGAG|AAGCAGCACCAATATATTCCCTCTAACCAC
CTTAGAACACTCAAGCAGCACCAATATATT|TAGGCGTTTAGCGGGGTGTGTTTACTCCCT
CCTGTGTCACGCGATACGGCCTGATATGGG|ATTAAACAATATCGCCGATGGGCATCCTGT
ATATCGCCGATGGGCATCCTGTGTTCCTGT|GGCATCCTGTGTTTGGATGGACTCTCCGGG
CTGTGTTGAGCCCGGCAATGGATATGGCTC|AGCCCGCTATCGCTACTAAGCGAATCTATT
GGTGGTGCCGAGAACTCTATGTGAGATACT|AATGGGTTGGTCACTATAAACAATATCGCC
AAACAATATCGCCGATGGGCATCCTGTGTT|TCAGGGCCGGTGGTGCCGAGAACTCTATGT
GTGTTTACTCCCTGAAGATCTTTGGGAGGG|CAAGAGGGTAAATAAACTGGGGGGCCGCGC
CCTCGGCTCCCAAACATAAAGGTGCGTGGC|GTCCGATAAACAATATCGCCGATGGGCATC
ACTATAAACAATATCGCCGATGGGCATCCT|TGGCTCTGCATCGACGTTAGCAATAAACAA
ATAGGCCTCACAGGCTATCCTAGCGTACGA|CGCCGATGGGCATCCTGTGTCTTGGTTTTC
ACAATATCGCCGATGGGCATCCTGTGTTTG|GGGGAGAATCTTAGAACACTCAAGCAGCAC
CGGGATAGAGATCAGGGCCGGTGGTGCCGA|CTCTAACCACGCTTCGTGAAATGGGTTGGT
GGCACTATAGACGGTGATTGGCTCTGCATC|GCAGGAGATCCTAATATCCCAAGACTTTTG
TATCGCCGATGGGCATCCTGTGTCTTGGTT|TCCTGTGTCACGCGATACGGCCTGATATGG
TCGTAATACGTTAGAGGTGGAGCACTAAAC|GACTCGTCCTTGCTAGGCTCGAGTCCCGGG
TGTTTATCGGCTATGACGCCTCGGCTCCCA|GGCATCCTGTGTTCCTGTGTCCGATAAACA
GTCCGATAAACAATATCGCCGATGGGCATC|ATAGAGATCAGGGCCGGTGGTGCCGAGAAC
GCCGATGGGCATCCTGTGTGAAAAACTCAA|CACAGGCTATCCTAGCGTACGACCCACGAT
AAGTAAACAATATCGCCGATGGGCATCCTG|CTTGCAGTAAATAAACAATATCGCCGATTA
GCCAAGAGGGTAAATAAACTGGGGGGCCGC|ACCTAACTCAGCGATTTACGTATAGTCCAC
AACAATATCGCCGATGGGCATCCTGTGTCC|ACGCCTCGGCTCCCAAACATAAAGGTGCGT
GCATCCTGTGTTCCTGTGTCCGATAAACAA|TGGATGGACTCTCCGGGATAGAGATCAGGG
CTCGTCCTTGCTAGGCTCGAGTCCCGGGGG|GTTAATATCCCCATGTATCGTACCACTTCA
TTAGAACACTCAAGCAGCACCAATATATTC|AGGCGTTTAGCGGGGTGTGTTTACTCCCTG
AACACTCAAGCAGCACCAATATATTCCCTC|GTTTAGCGGGGTGTGTTTACTCCCTGAAGA
GGCTATCCTAGCGTACGACCCACGATGGGA|TCCTGTGTCTTGGTTTTCCCCGTAAGGAAG
CGCGCAGGAGATCCTAATATCCCAAGACTT|CACCGATGACTTCCTAGTGGTCTTCATTAA
GACCCACGATGGGAAGAACCTACTACAATA|TCCCCGTAAGGAAGCGGACAATTCGATTAA
GTGGACTCGTCCTTGCTAGGCTCGAGTCCC|CCTGTGTTAATATCCCCATGTATCGTACCA
CTGTGTTCTTTGCTGCAGTGGGCCTAGTGT|CGATAGGGGAAAAGCATTGTACGGCTCTGG
AAACAGTAAACAATATCGCCGATGGGCATC|TCGCCGATGGGCATCCTGTGTCACGCGATA
AGCCCGCTATCGCTACTAAGCGAATCTATT|GCCGATGGGCATCCTGTGTTGATACTTCAG
AGATCAGGGCCGGTGGTGCCGAGAACTCTA|ACGCTTCGTGAAATGGGTTGGTCACTATAA
TGTTTGGATGGACTCTCCGGGATAGAGATC|CAGCACCAATATATTCCCTCTAACCACGCT
GCGTGGCTCTTGCAGTAAATAAACAATATC|GGGCATCCTGTGTTAGTAGAGCATAGCCTC
TATCGCCGATGGGCATCCTGTGTGGGCATA|GTTAGAGGTGGAGCACTAAACAATATCGCC
GTGAGATACTATATCTATAGTGGACTCGTC|CAATATCGCCGATGGGCATCCTGTGTTAAT
TAGGCCTCACAGGCTATCCTAGCGTACGAC|GCCGATGGGCATCCTGTGTCTTGGTTTTCC
CCGATGGGCATCCTGTGTTCCTGTGTCCGA|CTGTGTTTGGATGGACTCTCCGGGATAGAG
ACTCTCCGGGATAGAGATCAGGGCCGGTGG|TATTCCCTCTAACCACGCTTCGTGAAATGG
GGACTCTCCGGGATAGAGATCAGGGCCGGT|TATATTCCCTCTAACCACGCTTCGTGAAAT
CATCTTATCGCATCGATAGGGGAAAAGCAT|AACAATATCGCCGATGGGCATCCTGTGTCC
TATCGCCGATGGGCATCCTGTGTTGAGCCC|TGAATGCCTTATCGGTGAGCCCGCTATCGC
ATATATTCCCTCTAACCACGCTTCGTGAAA|ACTCCCTGAAGATCTTTGGGAGGGCACTAT
TCCCACTTATGAATGCCTTATCGGTGAGCC|CAATATCGCCGATGGGCATCCTGTGTGCCG
ACGGCAGAACGTGTTTATCGGCTATGACGC|TATCGCCGATGGGCATCCTGTGTTCCTGTG
GAGAACTCTATGTGAGATACTATATCTATA|GTCACTATAAACAATATCGCCGATGGGCAT
TTGGATGGACTCTCCGGGATAGAGATCAGG|CACCAATATATTCCCTCTAACCACGCTTCG
TCGCCGATGGGCATCCTGTGTCCGCGAAAG|GGCTCCCAAACATAAAGGTGCGTGGCTCTT
ATCGTACCACTTCACTAGTTAGGCGTTTAG|TGTGTTGAGCCCGGCAATGGATATGGCTCC
ATATCCCCATGTATCGTACCACTTCACTAG|CGATGGGCATCCTGTGTTGAGCCCGGCAAT
TATCGCCGATGGGCATCCTGTGTTAATATC|CGACGTTAGCAATAAACAATATCGCCGATG
TGGGAAGAACCTACTACAATACCCGTATCT|GGAAGCGGACAATTCGATTAAGCGTATGAT
GGGAGAATCTTAGAACACTCAAGCAGCACC|TCACTAGTTAGGCGTTTAGCGGGGTGTGTT
AGGGCACTATAGACGGTGATTGGCTCTGCA|GCGCAGGAGATCCTAATATCCCAAGACTTT
TGGGCATCCTGTGTCCGCGAAAGTAAACAA|AAACATAAAGGTGCGTGGCTCTTGCAGTAA
CATCGATAGGGGAAAAGCATTGTACGGCTC|CCGATGGGCATCCTGTGTCCGCGAAAGTAA
GATGGGCATCCTGTGTTAGTAGAGCATAGC|TGCCGAGAACTCTATGTGAGATACTATATC
TTCGTAATACGTTAGAGGTGGAGCACTAAA|GGACTCGTCCTTGCTAGGCTCGAGTCCCGG
GTGGCTCTTGCAGTAAATAAACAATATCGC|GCATCCTGTGTTAGTAGAGCATAGCCTCAG
TGGATATGGCTCCGGACGCCAAGAGGGTAA|AGCGAATCTATTCAACCACCTAACTCAGCG
TCTTAAACAATATCGCCGATGGGCATCCTG|GGGCATCCTGTGTTCTTTGCTGCAGTGGGC
TATATTCCCTCTAACCACGCTTCGTGAAAT|CTCCCTGAAGATCTTTGGGAGGGCACTATA
GCCGCGCAGGAGATCCTAATATCCCAAGAC|TCCACCGATGACTTCCTAGTGGTCTTCATT
CGCCGATTAAACAATATCGCCGATGGGCAT|CAGCTTCGTAATACGTTAGAGGTGGAGCAC
GCATCCTGTGTTAATATCCCCATGTATCGT|TAAACAATATCGCCGATGGGCATCCTGTGT
GATGGGCATCCTGTGTGAAAAACTCAACAT|AGGCTATCCTAGCGTACGACCCACGATGGG
AACAATATCGCCGATGGGCATCCTGTGTGA|TATAGGCCTCACAGGCTATCCTAGCGTACG
ATCGGTGAGCCCGCTATCGCTACTAAGCGA|CCTGTGTGCCGATGGGCATCCTGTGTTGAT
ACGCTTCGTGAAATGGGTTGGTCACTATAA|GGGAGGGCACTATAGACGGTGATTGGCTCT
TCGTACCACTTCACTAGTTAGGCGTTTAGC|GTGTTGAGCCCGGCAATGGATATGGCTCCG
ATCCTGTGTCACGCGATACGGCCTGATATG|CGATTAAACAATATCGCCGATGGGCATCCT
AACCACGCTTCGTGAAATGGGTTGGTCACT|CTTTGGGAGGGCACTATAGACGGTGATTGG
GGCGTTTAGCGGGGTGTGTTTACTCCCTGA|TATGGCTCCGGACGCCAAGAGGGTAAATAA
CCGATGGGCATCCTGTGTCCGCGAAAGTAA|TCCCAAACATAAAGGTGCGTGGCTCTTGCA
AGCACCAATATATTCCCTCTAACCACGCTT|TGTGTTTACTCCCTGAAGATCTTTGGGAGG
CCCCATGTATCGTACCACTTCACTAGTTAG|GGGCATCCTGTGTTGAGCCCGGCAATGGAT
CTAAACAATATCGCCGATGGGCATCCTGTG|AGCTATAGGCCTCACAGGCTATCCTAGCGT
GCACCAATATATTCCCTCTAACCACGCTTC|GTGTTTACTCCCTGAAGATCTTTGGGAGGG
GCGAAAGTAAACAATATCGCCGATGGGCAT|GGCTCTTGCAGTAAATAAACAATATCGCCG
TCCTGTGTTAGTAGAGCATAGCCTCAGCTT|ACTCTATGTGAGATACTATATCTATAGTGG
GTTCCTGTGTCCGATAAACAATATCGCCGA|TCTCCGGGATAGAGATCAGGGCCGGTGGTG
GGGCATCCTGTGTTCTTTGCTGCAGTGGGC|ATCGCATCGATAGGGGAAAAGCATTGTACG
AACGTGTTTATCGGCTATGACGCCTCGGCT|GATGGGCATCCTGTGTTCCTGTGTCCGATA
GTGCGTGGCTCTTGCAGTAAATAAACAATA|ATGGGCATCCTGTGTTAGTAGAGCATAGCC
TCAACATCGCGACATACCTATGTTAAACAA|CGATGGGAAGAACCTACTACAATACCCGTA
TCGACGTTAGCAATAAACAATATCGCCGAT|TGTCCGGAAATTCCCACTTATGAATGCCTT
CCGTATCTTCATCTTATCGCATCGATAGGG|CGTATGATAAACAATATCGCCGATGGGCAT
AGCATAGCCTCAGCTTCGTAATACGTTAGA|ACTATATCTATAGTGGACTCGTCCTTGCTA
TAGCGGGGTGTGTTTACTCCCTGAAGATCT|TCCGGACGCCAAGAGGGTAAATAAACTGGG
CCTTATCGGTGAGCCCGCTATCGCTACTAA|GCATCCTGTGTGCCGATGGGCATCCTGTGT
TCGCCGATGGGCATCCTGTGTCACGCGATA|AAACAATATCGCCGATTAAACAATATCGCC
CGATGGGCATCCTGTGTTCTTTGCTGCAGT|TCTTATCGCATCGATAGGGGAAAAGCATTG
GCATAAACAATATCGCCGATGGGCATCCTG|TCGCCGATGGGCATCCTGTGTTTGGATGGA
AACAATATCGCCGATTAAACAATATCGCCG|CATAGCCTCAGCTTCGTAATACGTTAGAGG
GGACGCCAAGAGGGTAAATAAACTGGGGGG|AACCACCTAACTCAGCGATTTACGTATAGT
CATCCTGTGTGGGCATAAACAATATCGCCG|CACTAAACAATATCGCCGATGGGCATCCTG
AACTCTATGTGAGATACTATATCTATAGTG|ACTATAAACAATATCGCCGATGGGCATCCT
CCTGTGTTCCTGTGTCCGATAAACAATATC|TGGACTCTCCGGGATAGAGATCAGGGCCGG
CTATAGGCCTCACAGGCTATCCTAGCGTAC|ATCGCCGATGGGCATCCTGTGTCTTGGTTT
CGCCTCGGCTCCCAAACATAAAGGTGCGTG|GTGTCCGATAAACAATATCGCCGATGGGCA
TGGGAGGGCACTATAGACGGTGATTGGCTC|GGCCGCGCAGGAGATCCTAATATCCCAAGA
ACGTTAGAGGTGGAGCACTAAACAATATCG|CCTTGCTAGGCTCGAGTCCCGGGGGAGAAT
TCTTGGTTTTCCCCGTAAGGAAGCGGACAA|TGATATGGGTGAGATTTTAGGTTACGGCAG
TGTTTACTCCCTGAAGATCTTTGGGAGGGC|AAGAGGGTAAATAAACTGGGGGGCCGCGCA
AGGAAGCGGACAATTCGATTAAGCGTATGA|TAGGTTACGGCAGAACGTGTTTATCGGCTA
GATCCTAATATCCCAAGACTTTTGTCCGGA|CTTCCTAGTGGTCTTCATTAAACAATATCT
CATCCTGTGTTGAGCCCGGCAATGGATATG|GGTGAGCCCGCTATCGCTACTAAGCGAATC
AAGACTTTTGTCCGGAAATTCCCACTTATG|TCATTAAACAATATCTAAACAATATCGCCG
ACTCTATGTGAGATACTATATCTATAGTGG|CTATAAACAATATCGCCGATGGGCATCCTG
CGTCCTTGCTAGGCTCGAGTCCCGGGGGAG|TAATATCCCCATGTATCGTACCACTTCACT
CCGCTATCGCTACTAAGCGAATCTATTCAA|GATGGGCATCCTGTGTTGATACTTCAGGTA
GCGTACGACCCACGATGGGAAGAACCTACT|TGGTTTTCCCCGTAAGGAAGCGGACAATTC
TTCGATTAAGCGTATGATAAACAATATCGC|AACGTGTTTATCGGCTATGACGCCTCGGCT
ATAAACAATATCGCCGATGGGCATCCTGTG|GCCGATGGGCATCCTGTGTTTGGATGGACT
AAACAATATCGCCGATGGGCATCCTGTGTC|ATCCTGTGTTCTTTGCTGCAGTGGGCCTAG
TGTGTCTTGGTTTTCCCCGTAAGGAAGCGG|GGCCTGATATGGGTGAGATTTTAGGTTACG
AACAATATCGCCGATGGGCATCCTGTGTTA|TGCATCGACGTTAGCAATAAACAATATCGC
GGGGTGTGTTTACTCCCTGAAGATCTTTGG|GACGCCAAGAGGGTAAATAAACTGGGGGGC
CGATGGGCATCCTGTGTCATCCCAGAATTA|TTGCTGCAGTGGGCCTAGTGTAGGGTAGAA
TCGCGACATACCTATGTTAAACAATATCGC|GAAGAACCTACTACAATACCCGTATCTTCA
GAGCCCGCTATCGCTACTAAGCGAATCTAT|TGCCGATGGGCATCCTGTGTTGATACTTCA
GGGCATCCTGTGTTGAGCCCGGCAATGGAT|ATCGGTGAGCCCGCTATCGCTACTAAGCGA
GATACTATATCTATAGTGGACTCGTCCTTG|ATCGCCGATGGGCATCCTGTGTTAATATCC
TGAAGATCTTTGGGAGGGCACTATAGACGG|TAAACTGGGGGGCCGCGCAGGAGATCCTAA
GACGGTGATTGGCTCTGCATCGACGTTAGC|CCTAATATCCCAAGACTTTTGTCCGGAAAT
CTATGTGAGATACTATATCTATAGTGGACT|TAAACAATATCGCCGATGGGCATCCTGTGT
GTAAACAATATCGCCGATGGGCATCCTGTG|TGCAGTAAATAAACAATATCGCCGATTAAA
AGACGGTGATTGGCTCTGCATCGACGTTAG|TCCTAATATCCCAAGACTTTTGTCCGGAAA
ATTCGATTAAGCGTATGATAAACAATATCG|GAACGTGTTTATCGGCTATGACGCCTCGGC
CCTGTGTGGGCATAAACAATATCGCCGATG|TAAACAATATCGCCGATGGGCATCCTGTGT
CAGGGCCGGTGGTGCCGAGAACTCTATGTG|TTCGTGAAATGGGTTGGTCACTATAAACAA
AGCAGCACCAATATATTCCCTCTAACCACG|GGGTGTGTTTACTCCCTGAAGATCTTTGGG
CATCCCAGAATTACAAGGACTAAACAATAT|GTGTAGGGTAGAATAGAAAAGCTATAGGCC
ATATCGCCGATTAAACAATATCGCCGATGG|GCCTCAGCTTCGTAATACGTTAGAGGTGGA
ACTCGTCCTTGCTAGGCTCGAGTCCCGGGG|TGTTAATATCCCCATGTATCGTACCACTTC
AGTAAATAAACAATATCGCCGATTAAACAA|TAGTAGAGCATAGCCTCAGCTTCGTAATAC
TTAAACAATATCGCCGATGGGCATCCTGTG|CGTAATACGTTAGAGGTGGAGCACTAAACA
TCACGCGATACGGCCTGATATGGGTGAGAT|CAATATCGCCGATGGGCATCCTGTGTGGGC
TAGAACACTCAAGCAGCACCAATATATTCC|GGCGTTTAGCGGGGTGTGTTTACTCCCTGA
GCATCCTGTGTTTGGATGGACTCTCCGGGA|CACTCAAGCAGCACCAATATATTCCCTCTA
GTGTTAATATCCCCATGTATCGTACCACTT|TATCGCCGATGGGCATCCTGTGTTGAGCCC
CACTAAACAATATCGCCGATGGGCATCCTG|GTCCCGGGGGAGAATCTTAGAACACTCAAG
TTCCCACTTATGAATGCCTTATCGGTGAGC|ACAATATCGCCGATGGGCATCCTGTGTGCC
ATATCGCCGATGGGCATCCTGTGTCCGCGA|CTCGGCTCCCAAACATAAAGGTGCGTGGCT
CTATGACGCCTCGGCTCCCAAACATAAAGG|GTTCCTGTGTCCGATAAACAATATCGCCGA
TATGATAAACAATATCGCCGATGGGCATCC|GGCTATGACGCCTCGGCTCCCAAACATAAA
ACTAAGCGAATCTATTCAACCACCTAACTC|TGTGTTGATACTTCAGGTACGTATCGAAGC
AGTAAACAATATCGCCGATGGGCATCCTGT|TTGCAGTAAATAAACAATATCGCCGATTAA
AGAGGTGGAGCACTAAACAATATCGCCGAT|CTAGGCTCGAGTCCCGGGGGAGAATCTTAG
AGCGGGGTGTGTTTACTCCCTGAAGATCTT|CCGGACGCCAAGAGGGTAAATAAACTGGGG
ACAATATCGCCGATGGGCATCCTGTGTTAG|AGGGCCGGTGGTGCCGAGAACTCTATGTGA
TACAAGGACTAAACAATATCGCCGATGGGC|AATAGAAAAGCTATAGGCCTCACAGGCTAT
GCGTTTAGCGGGGTGTGTTTACTCCCTGAA|ATGGCTCCGGACGCCAAGAGGGTAAATAAA
GCATCCTGTGTGAAAAACTCAACATCGCGA|ATCCTAGCGTACGACCCACGATGGGAAGAA
GCCCGGCAATGGATATGGCTCCGGACGCCA|TCGCTACTAAGCGAATCTATTCAACCACCT
TTGGGAGGGCACTATAGACGGTGATTGGCT|GGGCCGCGCAGGAGATCCTAATATCCCAAG
CGTAATACGTTAGAGGTGGAGCACTAAACA|ACTCGTCCTTGCTAGGCTCGAGTCCCGGGG
GTCTTGGTTTTCCCCGTAAGGAAGCGGACA|CTGATATGGGTGAGATTTTAGGTTACGGCA
TATCTTCATCTTATCGCATCGATAGGGGAA|ATGATAAACAATATCGCCGATGGGCATCCT
TAGTGGACTCGTCCTTGCTAGGCTCGAGTC|ATCCTGTGTTAATATCCCCATGTATCGTAC
CGTGGCTCTTGCAGTAAATAAACAATATCG|GGCATCCTGTGTTAGTAGAGCATAGCCTCA
AAACAATATCGCCGATGGGCATCCTGTGTG|CTATAGGCCTCACAGGCTATCCTAGCGTAC
ATGTGAGATACTATATCTATAGTGGACTCG|AACAATATCGCCGATGGGCATCCTGTGTTA
AGCGTATGATAAACAATATCGCCGATGGGC|TATCGGCTATGACGCCTCGGCTCCCAAACA
CATCCTGTGTCTTGGTTTTCCCCGTAAGGA|GATACGGCCTGATATGGGTGAGATTTTAGG
ACATCGCGACATACCTATGTTAAACAATAT|TGGGAAGAACCTACTACAATACCCGTATCT
GGAAAAGCATTGTACGGCTCTGGCCAAAAC|TCCTGTGTCCGCGAAAGTAAACAATATCGC
CACTTATGAATGCCTTATCGGTGAGCCCGC|TATCGCCGATGGGCATCCTGTGTGCCGATG
TATGGCTCCGGACGCCAAGAGGGTAAATAA|AATCTATTCAACCACCTAACTCAGCGATTT
CTGTGTCTTGGTTTTCCCCGTAAGGAAGCG|CGGCCTGATATGGGTGAGATTTTAGGTTAC
GCCAAAACAGTAAACAATATCGCCGATGGG|AATATCGCCGATGGGCATCCTGTGTCACGC
GCGAATCTATTCAACCACCTAACTCAGCGA|TGATACTTCAGGTACGTATCGAAGCCCTAT
TTACGGCAGAACGTGTTTATCGGCTATGAC|AATATCGCCGATGGGCATCCTGTGTTCCTG
GATAAACAATATCGCCGATGGGCATCCTGT|TATGACGCCTCGGCTCCCAAACATAAAGGT
TCCTTGCTAGGCTCGAGTCCCGGGGGAGAA|ATATCCCCATGTATCGTACCACTTCACTAG
CCGAGAACTCTATGTGAGATACTATATCTA|TGGTCACTATAAACAATATCGCCGATGGGC
CGGCTATGACGCCTCGGCTCCCAAACATAA|TGTGTTCCTGTGTCCGATAAACAATATCGC
CGACCCACGATGGGAAGAACCTACTACAAT|TTCCCCGTAAGGAAGCGGACAATTCGATTA
TGCAGTGGGCCTAGTGTAGGGTAGAATAGA|GCATTGTACGGCTCTGGCCAAAACAGTAAA
CCGGCAATGGATATGGCTCCGGACGCCAAG|GCTACTAAGCGAATCTATTCAACCACCTAA
AACATAAAGGTGCGTGGCTCTTGCAGTAAA|ATATCGCCGATGGGCATCCTGTGTTAGTAG
GGCAATGGATATGGCTCCGGACGCCAAGAG|TACTAAGCGAATCTATTCAACCACCTAACT
CTCGGCTCCCAAACATAAAGGTGCGTGGCT|TCCGATAAACAATATCGCCGATGGGCATCC
AGGACTAAACAATATCGCCGATGGGCATCC|GAAAAGCTATAGGCCTCACAGGCTATCCTA
TAAACAATATCGCCGATTAAACAATATCGC|AGCATAGCCTCAGCTTCGTAATACGTTAGA
ATCTATAGTGGACTCGTCCTTGCTAGGCTC|TGGGCATCCTGTGTTAATATCCCCATGTAT
TCGCCGATGGGCATCCTGTGTTTGGATGGA|AATCTTAGAACACTCAAGCAGCACCAATAT
GGAGAATCTTAGAACACTCAAGCAGCACCA|CACTAGTTAGGCGTTTAGCGGGGTGTGTTT
ACGTGTTTATCGGCTATGACGCCTCGGCTC|ATGGGCATCCTGTGTTCCTGTGTCCGATAA
AGGCGTTTAGCGGGGTGTGTTTACTCCCTG|ATATGGCTCCGGACGCCAAGAGGGTAAATA
GGGCATCCTGTGTTAGTAGAGCATAGCCTC|CGAGAACTCTATGTGAGATACTATATCTAT
GAATCTATTCAACCACCTAACTCAGCGATT|ATACTTCAGGTACGTATCGAAGCCCTATCC
GGCCTCACAGGCTATCCTAGCGTACGACCC|CGATGGGCATCCTGTGTCTTGGTTTTCCCC
ACAATATCGCCGATGGGCATCCTGTGTTGA|CTTATGAATGCCTTATCGGTGAGCCCGCTA
TGAAAAACTCAACATCGCGACATACCTATG|ACGACCCACGATGGGAAGAACCTACTACAA
CGCCGATGGGCATCCTGTGTGGGCATAAAC|AGAGGTGGAGCACTAAACAATATCGCCGAT
TTGGCTCTGCATCGACGTTAGCAATAAACA|CCCAAGACTTTTGTCCGGAAATTCCCACTT
TATAGACGGTGATTGGCTCTGCATCGACGT|AGATCCTAATATCCCAAGACTTTTGTCCGG
AGTAGAGCATAGCCTCAGCTTCGTAATACG|GAGATACTATATCTATAGTGGACTCGTCCT
TGGACTCTCCGGGATAGAGATCAGGGCCGG|ATATATTCCCTCTAACCACGCTTCGTGAAA
GAAGAACCTACTACAATACCCGTATCTTCA|AGCGGACAATTCGATTAAGCGTATGATAAA
AGGCTATCCTAGCGTACGACCCACGATGGG|ATCCTGTGTCTTGGTTTTCCCCGTAAGGAA
CAACCACCTAACTCAGCGATTTACGTATAG|GTACGTATCGAAGCCCTATCCGCGCGACTT
CCTCACAGGCTATCCTAGCGTACGACCCAC|ATGGGCATCCTGTGTCTTGGTTTTCCCCGT
CATCCTGTGTCATCCCAGAATTACAAGGAC|AGTGGGCCTAGTGTAGGGTAGAATAGAAAA
GAGTCCCGGGGGAGAATCTTAGAACACTCA|CGTACCACTTCACTAGTTAGGCGTTTAGCG
CCCGTAAGGAAGCGGACAATTCGATTAAGC|AGATTTTAGGTTACGGCAGAACGTGTTTAT
CAATTCGATTAAGCGTATGATAAACAATAT|CAGAACGTGTTTATCGGCTATGACGCCTCG
TTACAAGGACTAAACAATATCGCCGATGGG|GAATAGAAAAGCTATAGGCCTCACAGGCTA
ATGGGCATCCTGTGTCCGCGAAAGTAAACA|CAAACATAAAGGTGCGTGGCTCTTGCAGTA
GACTAAACAATATCGCCGATGGGCATCCTG|AAAGCTATAGGCCTCACAGGCTATCCTAGC
GCCGATGGGCATCCTGTGTTAATATCCCCA|GTTAGCAATAAACAATATCGCCGATGGGCA
TATCGCCGATGGGCATCCTGTGTCCGCGAA|TCGGCTCCCAAACATAAAGGTGCGTGGCTC
GGGCCTAGTGTAGGGTAGAATAGAAAAGCT|TACGGCTCTGGCCAAAACAGTAAACAATAT
AATAAACTGGGGGGCCGCGCAGGAGATCCT|GATTTACGTATAGTCCACCGATGACTTCCT
CATAAAGGTGCGTGGCTCTTGCAGTAAATA|ATCGCCGATGGGCATCCTGTGTTAGTAGAG
TAAACAATATCGCCGATGGGCATCCTGTGT|CCGATGGGCATCCTGTGTTTGGATGGACTC
CATAGCCTCAGCTTCGTAATACGTTAGAGG|TATATCTATAGTGGACTCGTCCTTGCTAGG
ACAATATCGCCGATGGGCATCCTGTGTCAT|CCTGTGTTCTTTGCTGCAGTGGGCCTAGTG
GAACTCTATGTGAGATACTATATCTATAGT|CACTATAAACAATATCGCCGATGGGCATCC
AAGCTATAGGCCTCACAGGCTATCCTAGCG|AATATCGCCGATGGGCATCCTGTGTCTTGG
ACAATATCGCCGATGGGCATCCTGTGTCAC|GTAAATAAACAATATCGCCGATTAAACAAT
CAGCTTCGTAATACGTTAGAGGTGGAGCAC|TAGTGGACTCGTCCTTGCTAGGCTCGAGTC
GATTTTAGGTTACGGCAGAACGTGTTTATC|GGCATAAACAATATCGCCGATGGGCATCCT
ATCGCCGATGGGCATCCTGTGTTCCTGTGT|CATCCTGTGTTTGGATGGACTCTCCGGGAT
TATAGTGGACTCGTCCTTGCTAGGCTCGAG|GCATCCTGTGTTAATATCCCCATGTATCGT
AATAAACAATATCGCCGATGGGCATCCTGT|TCCCACTTATGAATGCCTTATCGGTGAGCC
TGCCGAGAACTCTATGTGAGATACTATATC|GTTGGTCACTATAAACAATATCGCCGATGG
AATAGAAAAGCTATAGGCCTCACAGGCTAT|AGTAAACAATATCGCCGATGGGCATCCTGT
ATGGGCATCCTGTGTTAATATCCCCATGTA|GCAATAAACAATATCGCCGATGGGCATCCT
CCTGATATGGGTGAGATTTTAGGTTACGGC|GGGCATCCTGTGTGGGCATAAACAATATCG
CTCCCTGAAGATCTTTGGGAGGGCACTATA|GTAAATAAACTGGGGGGCCGCGCAGGAGAT
CGGGGTGTGTTTACTCCCTGAAGATCTTTG|GGACGCCAAGAGGGTAAATAAACTGGGGGG
ATATCGCCGATGGGCATCCTGTGTGAAAAA|GGCCTCACAGGCTATCCTAGCGTACGACCC
TCCTGTGTGGGCATAAACAATATCGCCGAT|CTAAACAATATCGCCGATGGGCATCCTGTG
TACGGCTCTGGCCAAAACAGTAAACAATAT|GAAAGTAAACAATATCGCCGATGGGCATCC
ACGTTAGCAATAAACAATATCGCCGATGGG|CCGGAAATTCCCACTTATGAATGCCTTATC
GCTTCGTGAAATGGGTTGGTCACTATAAAC|GAGGGCACTATAGACGGTGATTGGCTCTGC
ACAATATCGCCGATGGGCATCCTGTGTTAA|GCATCGACGTTAGCAATAAACAATATCGCC
GCCGATGGGCATCCTGTGTTGAGCCCGGCA|TGCCTTATCGGTGAGCCCGCTATCGCTACT
CGGTGGTGCCGAGAACTCTATGTGAGATAC|AAATGGGTTGGTCACTATAAACAATATCGC
AAAGCATTGTACGGCTCTGGCCAAAACAGT|TGTGTCCGCGAAAGTAAACAATATCGCCGA
TAAACAATATCGCCGATGGGCATCCTGTGT|GTAATACGTTAGAGGTGGAGCACTAAACAA
GTACGGCTCTGGCCAAAACAGTAAACAATA|CGAAAGTAAACAATATCGCCGATGGGCATC
CCTGTGTTCTTTGCTGCAGTGGGCCTAGTG|TCGATAGGGGAAAAGCATTGTACGGCTCTG
GCTGCAGTGGGCCTAGTGTAGGGTAGAATA|AAGCATTGTACGGCTCTGGCCAAAACAGTA
TGGATGGACTCTCCGGGATAGAGATCAGGG|ACCAATATATTCCCTCTAACCACGCTTCGT
GTCACGCGATACGGCCTGATATGGGTGAGA|ACAATATCGCCGATGGGCATCCTGTGTGGG
GAACCTACTACAATACCCGTATCTTCATCT|GGACAATTCGATTAAGCGTATGATAAACAA
TGTGAGATACTATATCTATAGTGGACTCGT|ACAATATCGCCGATGGGCATCCTGTGTTAA
CCGGGATAGAGATCAGGGCCGGTGGTGCCG|CCTCTAACCACGCTTCGTGAAATGGGTTGG
TCGATAGGGGAAAAGCATTGTACGGCTCTG|GATGGGCATCCTGTGTCCGCGAAAGTAAAC
ATCGCCGATGGGCATCCTGTGTGGGCATAA|TTAGAGGTGGAGCACTAAACAATATCGCCG
TGTGTCCGCGAAAGTAAACAATATCGCCGA|GGTGCGTGGCTCTTGCAGTAAATAAACAAT
GTGTGAAAAACTCAACATCGCGACATACCT|CGTACGACCCACGATGGGAAGAACCTACTA
ATATCGCCGATGGGCATCCTGTGTTGAGCC|ATGAATGCCTTATCGGTGAGCCCGCTATCG
CGGTGAGCCCGCTATCGCTACTAAGCGAAT|TGTGTGCCGATGGGCATCCTGTGTTGATAC
GGCATCCTGTGTGAAAAACTCAACATCGCG|TATCCTAGCGTACGACCCACGATGGGAAGA
AGAGCATAGCCTCAGCTTCGTAATACGTTA|ATACTATATCTATAGTGGACTCGTCCTTGC
GACGTTAGCAATAAACAATATCGCCGATGG|TCCGGAAATTCCCACTTATGAATGCCTTAT
CGATGGGCATCCTGTGTCACGCGATACGGC|AATATCGCCGATTAAACAATATCGCCGATG
ATGACGCCTCGGCTCCCAAACATAAAGGTG|TCCTGTGTCCGATAAACAATATCGCCGATG
GGGCACTATAGACGGTGATTGGCTCTGCAT|CGCAGGAGATCCTAATATCCCAAGACTTTT
GGCTCCCAAACATAAAGGTGCGTGGCTCTT|GATAAACAATATCGCCGATGGGCATCCTGT
GTGGGCCTAGTGTAGGGTAGAATAGAAAAG|TGTACGGCTCTGGCCAAAACAGTAAACAAT
GGCATCCTGTGTTCTTTGCTGCAGTGGGCC|TCGCATCGATAGGGGAAAAGCATTGTACGG
AAACAATATCGCCGATGGGCATCCTGTGTT|CCCGTATCTTCATCTTATCGCATCGATAGG
CGATGGGCATCCTGTGTTCCTGTGTCCGAT|TGTGTTTGGATGGACTCTCCGGGATAGAGA
TTGTCTTAAACAATATCGCCGATGGGCATC|GATGGGCATCCTGTGTTCTTTGCTGCAGTG
GGCATCCTGTGTTAGTAGAGCATAGCCTCA|GAGAACTCTATGTGAGATACTATATCTATA
TCGTGAAATGGGTTGGTCACTATAAACAAT|GGCACTATAGACGGTGATTGGCTCTGCATC
CGTACGACCCACGATGGGAAGAACCTACTA|GGTTTTCCCCGTAAGGAAGCGGACAATTCG
ATCGCCGATGGGCATCCTGTGTGAAAAACT|CCTCACAGGCTATCCTAGCGTACGACCCAC
CACTTCACTAGTTAGGCGTTTAGCGGGGTG|AGCCCGGCAATGGATATGGCTCCGGACGCC
CTACTACAATACCCGTATCTTCATCTTATC|AATTCGATTAAGCGTATGATAAACAATATC
TTGGTTTTCCCCGTAAGGAAGCGGACAATT|ATATGGGTGAGATTTTAGGTTACGGCAGAA
TTTGGATGGACTCTCCGGGATAGAGATCAG|GCACCAATATATTCCCTCTAACCACGCTTC
ACCACTTCACTAGTTAGGCGTTTAGCGGGG|TGAGCCCGGCAATGGATATGGCTCCGGACG
CCATGAATTGGCTATTTGTCTTAAACAATA|TTAAACAATATCGCCGATGGGCATCCTGTG
GAATTACAAGGACTAAACAATATCGCCGAT|GTAGAATAGAAAAGCTATAGGCCTCACAGG
AAACAATATCGCCGATGGGCATCCTGTGTT|CACTTATGAATGCCTTATCGGTGAGCCCGC
CCGGGGGAGAATCTTAGAACACTCAAGCAG|CACTTCACTAGTTAGGCGTTTAGCGGGGTG
ATCGCGACATACCTATGTTAAACAATATCG|GGAAGAACCTACTACAATACCCGTATCTTC
ATCCTGTGTTAGTAGAGCATAGCCTCAGCT|AACTCTATGTGAGATACTATATCTATAGTG
AGAACCTACTACAATACCCGTATCTTCATC|CGGACAATTCGATTAAGCGTATGATAAACA
ATAAACAATATCGCCGATGGGCATCCTGTG|CTCTGCATCGACGTTAGCAATAAACAATAT
GCAATGGATATGGCTCCGGACGCCAAGAGG|ACTAAGCGAATCTATTCAACCACCTAACTC
TTTTAGGTTACGGCAGAACGTGTTTATCGG|CATAAACAATATCGCCGATGGGCATCCTGT
GGCCTAGTGTAGGGTAGAATAGAAAAGCTA|ACGGCTCTGGCCAAAACAGTAAACAATATC
ACGCCAAGAGGGTAAATAAACTGGGGGGCC|CCACCTAACTCAGCGATTTACGTATAGTCC
AGCGTACGACCCACGATGGGAAGAACCTAC|TTGGTTTTCCCCGTAAGGAAGCGGACAATT
CTGCAGTGGGCCTAGTGTAGGGTAGAATAG|AGCATTGTACGGCTCTGGCCAAAACAGTAA
ATATCGCCGATGGGCATCCTGTGTTTGGAT|GAGAATCTTAGAACACTCAAGCAGCACCAA
GTACCACTTCACTAGTTAGGCGTTTAGCGG|GTTGAGCCCGGCAATGGATATGGCTCCGGA
TGTCCGCGAAAGTAAACAATATCGCCGATG|TGCGTGGCTCTTGCAGTAAATAAACAATAT
GCGGACAATTCGATTAAGCGTATGATAAAC|TACGGCAGAACGTGTTTATCGGCTATGACG
GAGATACTATATCTATAGTGGACTCGTCCT|ATATCGCCGATGGGCATCCTGTGTTAATAT
GTAAATAAACAATATCGCCGATTAAACAAT|AGTAGAGCATAGCCTCAGCTTCGTAATACG
CTCAGCTTCGTAATACGTTAGAGGTGGAGC|TATAGTGGACTCGTCCTTGCTAGGCTCGAG
CCGTAAGGAAGCGGACAATTCGATTAAGCG|GATTTTAGGTTACGGCAGAACGTGTTTATC
GTGTCCGATAAACAATATCGCCGATGGGCA|GGATAGAGATCAGGGCCGGTGGTGCCGAGA
CGAGTCCCGGGGGAGAATCTTAGAACACTC|TCGTACCACTTCACTAGTTAGGCGTTTAGC
CATGTATCGTACCACTTCACTAGTTAGGCG|CATCCTGTGTTGAGCCCGGCAATGGATATG
TAGAGGTGGAGCACTAAACAATATCGCCGA|GCTAGGCTCGAGTCCCGGGGGAGAATCTTA
GGTGAGATTTTAGGTTACGGCAGAACGTGT|GTGTGGGCATAAACAATATCGCCGATGGGC
TGTGTCATCCCAGAATTACAAGGACTAAAC|GCCTAGTGTAGGGTAGAATAGAAAAGCTAT
TGTGGGCATAAACAATATCGCCGATGGGCA|CAATATCGCCGATGGGCATCCTGTGTTTGG
AACAATATCGCCGATGGGCATCCTGTGTCA|AGTAAATAAACAATATCGCCGATTAAACAA
ATAGACGGTGATTGGCTCTGCATCGACGTT|GATCCTAATATCCCAAGACTTTTGTCCGGA
TATCGCCGATGGGCATCCTGTGTTCTTTGC|TCTTCATCTTATCGCATCGATAGGGGAAAA
ATACGTTAGAGGTGGAGCACTAAACAATAT|GTCCTTGCTAGGCTCGAGTCCCGGGGGAGA
ACCTACTACAATACCCGTATCTTCATCTTA|ACAATTCGATTAAGCGTATGATAAACAATA
CGGCCTGATATGGGTGAGATTTTAGGTTAC|GATGGGCATCCTGTGTGGGCATAAACAATA
CCTTGCTAGGCTCGAGTCCCGGGGGAGAAT|TATCCCCATGTATCGTACCACTTCACTAGT
ACAATTCGATTAAGCGTATGATAAACAATA|GCAGAACGTGTTTATCGGCTATGACGCCTC
AAACATAAAGGTGCGTGGCTCTTGCAGTAA|AATATCGCCGATGGGCATCCTGTGTTAGTA
TTAAGCGTATGATAAACAATATCGCCGATG|GTTTATCGGCTATGACGCCTCGGCTCCCAA
CCTGTGTCTTGGTTTTCCCCGTAAGGAAGC|ACGGCCTGATATGGGTGAGATTTTAGGTTA
GGCTCTGCATCGACGTTAGCAATAAACAAT|CAAGACTTTTGTCCGGAAATTCCCACTTAT
GTGTTCCTGTGTCCGATAAACAATATCGCC|ACTCTCCGGGATAGAGATCAGGGCCGGTGG
GGAAGAACCTACTACAATACCCGTATCTTC|AAGCGGACAATTCGATTAAGCGTATGATAA
CTTCGTGAAATGGGTTGGTCACTATAAACA|AGGGCACTATAGACGGTGATTGGCTCTGCA
ATACCTATGTTAAACAATATCGCCGATGGG|CTACTACAATACCCGTATCTTCATCTTATC
TCTATGTGAGATACTATATCTATAGTGGAC|ATAAACAATATCGCCGATGGGCATCCTGTG
CTTATCGGTGAGCCCGCTATCGCTACTAAG|CATCCTGTGTGCCGATGGGCATCCTGTGTT
ATGGGCATCCTGTGTGAAAAACTCAACATC|GGCTATCCTAGCGTACGACCCACGATGGGA
TGGTCACTATAAACAATATCGCCGATGGGC|GTGATTGGCTCTGCATCGACGTTAGCAATA
GGCATAAACAATATCGCCGATGGGCATCCT|ATCGCCGATGGGCATCCTGTGTTTGGATGG
CGATGGGCATCCTGTGTCTTGGTTTTCCCC|GTCACGCGATACGGCCTGATATGGGTGAGA
CGCCGATGGGCATCCTGTGTCCGCGAAAGT|GCTCCCAAACATAAAGGTGCGTGGCTCTTG
TACCACTTCACTAGTTAGGCGTTTAGCGGG|TTGAGCCCGGCAATGGATATGGCTCCGGAC
ATCCTGTGTTTGGATGGACTCTCCGGGATA|CTCAAGCAGCACCAATATATTCCCTCTAAC
GCTCCGGACGCCAAGAGGGTAAATAAACTG|TATTCAACCACCTAACTCAGCGATTTACGT
CGGCAATGGATATGGCTCCGGACGCCAAGA|CTACTAAGCGAATCTATTCAACCACCTAAC
TTATCGGCTATGACGCCTCGGCTCCCAAAC|ATCCTGTGTTCCTGTGTCCGATAAACAATA
CTATAAACAATATCGCCGATGGGCATCCTG|GGCTCTGCATCGACGTTAGCAATAAACAAT
ATGGGCATCCTGTGTCTTGGTTTTCCCCGT|CACGCGATACGGCCTGATATGGGTGAGATT
TTCCCCGTAAGGAAGCGGACAATTCGATTA|GTGAGATTTTAGGTTACGGCAGAACGTGTT
GTGAAAAACTCAACATCGCGACATACCTAT|TACGACCCACGATGGGAAGAACCTACTACA
GATGGGCATCCTGTGTCTTGGTTTTCCCCG|TCACGCGATACGGCCTGATATGGGTGAGAT
GGGCATCCTGTGTCATCCCAGAATTACAAG|TGCAGTGGGCCTAGTGTAGGGTAGAATAGA
ATGGGCATCCTGTGTTCCTGTGTCCGATAA|TGTTTGGATGGACTCTCCGGGATAGAGATC
AGGCTCGAGTCCCGGGGGAGAATCTTAGAA|ATGTATCGTACCACTTCACTAGTTAGGCGT
AAATTCCCACTTATGAATGCCTTATCGGTG|TAAACAATATCGCCGATGGGCATCCTGTGT
TACGACCCACGATGGGAAGAACCTACTACA|TTTTCCCCGTAAGGAAGCGGACAATTCGAT
TAGAAAAGCTATAGGCCTCACAGGCTATCC|TAAACAATATCGCCGATGGGCATCCTGTGT
AGATCCTAATATCCCAAGACTTTTGTCCGG|ACTTCCTAGTGGTCTTCATTAAACAATATC
TTTAGCGGGGTGTGTTTACTCCCTGAAGAT|GCTCCGGACGCCAAGAGGGTAAATAAACTG
ATAAACAATATCGCCGATTAAACAATATCG|GAGCATAGCCTCAGCTTCGTAATACGTTAG
GACTCTCCGGGATAGAGATCAGGGCCGGTG|ATATTCCCTCTAACCACGCTTCGTGAAATG
TCCCTCTAACCACGCTTCGTGAAATGGGTT|TGAAGATCTTTGGGAGGGCACTATAGACGG
ATCAGGGCCGGTGGTGCCGAGAACTCTATG|GCTTCGTGAAATGGGTTGGTCACTATAAAC
GGGCATCCTGTGTGAAAAACTCAACATCGC|CTATCCTAGCGTACGACCCACGATGGGAAG
CTTCATCTTATCGCATCGATAGGGGAAAAG|ATAAACAATATCGCCGATGGGCATCCTGTG
GTTGGTCACTATAAACAATATCGCCGATGG|CGGTGATTGGCTCTGCATCGACGTTAGCAA
GCTACTAAGCGAATCTATTCAACCACCTAA|TCCTGTGTTGATACTTCAGGTACGTATCGA
AAACTCAACATCGCGACATACCTATGTTAA|CCCACGATGGGAAGAACCTACTACAATACC
AAACAATATCGCCGATGGGCATCCTGTGTT|CTGCATCGACGTTAGCAATAAACAATATCG
AGGGTAGAATAGAAAAGCTATAGGCCTCAC|CCAAAACAGTAAACAATATCGCCGATGGGC
GATAAACAATATCGCCGATGGGCATCCTGT|AGATCAGGGCCGGTGGTGCCGAGAACTCTA
AGGGGAAAAGCATTGTACGGCTCTGGCCAA|GCATCCTGTGTCCGCGAAAGTAAACAATAT
CTGTGTCCGATAAACAATATCGCCGATGGG|CGGGATAGAGATCAGGGCCGGTGGTGCCGA
CCACGATGGGAAGAACCTACTACAATACCC|CCGTAAGGAAGCGGACAATTCGATTAAGCG
GGGCCGCGCAGGAGATCCTAATATCCCAAG|AGTCCACCGATGACTTCCTAGTGGTCTTCA
ATGTATCGTACCACTTCACTAGTTAGGCGT|ATCCTGTGTTGAGCCCGGCAATGGATATGG
GGTTGGTCACTATAAACAATATCGCCGATG|ACGGTGATTGGCTCTGCATCGACGTTAGCA
TGAGCCCGCTATCGCTACTAAGCGAATCTA|GTGCCGATGGGCATCCTGTGTTGATACTTC
ATGGCTCCGGACGCCAAGAGGGTAAATAAA|ATCTATTCAACCACCTAACTCAGCGATTTA
CATTGTACGGCTCTGGCCAAAACAGTAAAC|TCCGCGAAAGTAAACAATATCGCCGATGGG
TGTGTTCTTTGCTGCAGTGGGCCTAGTGTA|GATAGGGGAAAAGCATTGTACGGCTCTGGC
CCACTTATGAATGCCTTATCGGTGAGCCCG|ATATCGCCGATGGGCATCCTGTGTGCCGAT
AGCTTCGTAATACGTTAGAGGTGGAGCACT|AGTGGACTCGTCCTTGCTAGGCTCGAGTCC
TAAACAATATCGCCGATGGGCATCCTGTGT|TCTGCATCGACGTTAGCAATAAACAATATC
CATCCTGTGTTAATATCCCCATGTATCGTA|AAACAATATCGCCGATGGGCATCCTGTGTT
GAATGCCTTATCGGTGAGCCCGCTATCGCT|GATGGGCATCCTGTGTGCCGATGGGCATCC
GGCTCCGGACGCCAAGAGGGTAAATAAACT|CTATTCAACCACCTAACTCAGCGATTTACG
GAGGTGGAGCACTAAACAATATCGCCGATG|TAGGCTCGAGTCCCGGGGGAGAATCTTAGA
CACCAATATATTCCCTCTAACCACGCTTCG|TGTTTACTCCCTGAAGATCTTTGGGAGGGC
TGTGTGAAAAACTCAACATCGCGACATACC|GCGTACGACCCACGATGGGAAGAACCTACT
